label	wubi
说	yu
㐻	wmwy
蓳	aakg
䆎	twwg
喹	kdf
窛	pwfv
霎	fuv
㞡	naae
児	hjqb
忛	nmyy
諓	yaat
胘	eyxy
䌘	umiir
䀕	hxhh
銜	tqfh
柴	hxs
䞷	fhnm
袚	pudc
婼	vadk
管	tp
层	nfc
䂥	dnan
構	sfjfd
趐	fhnd
怇	nang
懣	iamn
垁	ftdy
㬅	jldn
㥋	wyen
裒	yveu
彙	xgps
䠋	khrf
剄	gvaj
䩦	whtf
疶	uanv
噿	knyf
黦	lfob
唦	kiit
踵	khtf
誙	ygva
㧩	rmgh
构	sq
䏘	eaqn
懌	nlff
坾	fpsh
䢄	ckus
砹	daqy
徥	tjghg
譿	ydhn
㒱	tyqu
嫪	vnwe
陱	bqoy
壡	hpgf
㾕	uukn
铕	qdeg
冺	unand
惂	nqvgw
砪	dxgu
䐢	eqbt
庖	yqn
䓲	awuq
䔊	agua
迯	qhpi
㧔	rdnt
湒	ikbg
呚	ktyp
阫	bgiy
儥	wflm
烶	otfp
汘	itfhx
宄	pvb
棿	svqn
㭭	sklj
䃐	dpwd
瀷	inlw
翻	toln
䍺	udkn
陯	bwga
庯	ygey
䥐	cbtqf
喦	kkkmp
匦	alv
㧖	rynnt
跩	khjx
千	tfk
霐	fixc
祤	pyng
釲	qnnl
鍔	qkknt
砣	dpx
呝	kynn
劯	dln
亭	yps
禓	pyjr
鬲	gkmh
䤊	sgab
楓	smtj
俓	wgva
杨	sn
傜	werm
堵	fft
硈	dfkg
覹	hqtt
橘	scbk
䪥	hpgg
呂	ktkf
朝	fje
㪑	djnc
傱	wtwh
腰	esv
瓙	gfno
㙵	fymf
曩	jyk
滬	iynca
䉌	tbue
㓆	uwxn
鬐	defj
熵	oum
諼	yefc
㥩	nftjz
肕	evyy
氩	rngg
䨻	flfli
僉	wgkwv
里	jfd
廴	pny
藅	alyj
俦	wdtf
丑	nfd
彧	akge
舏	tdnh
珳	gyet
俎	wweg
毿	cccnx
夰	djj
麿	yssk
鏹	qxkj
鐅	umiq
搘	rftj
葽	asvf
于	gf
疺	utpi
逷	jqrp
躓	khrmx
侍	wff
浣	ipfq
痹	ulgj
夥	jsq
瑌	gdmd
㜅	vyxl
晷	jthk
弝	xcnn
諠	ypgg
焚	sso
鍞	qhmy
檿	djes
敝	umi
昬	najf
哪	kv
囦	lii
萃	ayw
徵	tmgty
舩	tewcb
澇	iool
䖲	jqjg
㒦	wllf
嫡	vum
鎛	qgefv
旀	yciy
癆	uool
名	qk
䜗	ydgn
㗃	knaj
嶤	mffq
尅	dqfi
㦯	acgd
轼	laa
扠	rcyyz
䩸	afab
秈	tmhb
欌	sadt
娣	vux
赌	mftjf
䖮	jtmk
挫	rww
攇	rpdn
窥	pwfqa
倂	wtff
瞎	hp
唉	kct
祏	pydg
楀	stky
翯	nymk
饩	qnrn
穜	tujfk
蜙	jswc
斑	gyge
绰	xhj
錵	qawx
㺨	gcy
猎	qta
炩	owyc
扯	rhg
朋	ee
扑	rhy
㦡	nxrs
詔	yvkg
﨓	sawf
徲	tnih
慗	gkin
嚷	kyk
䁑	hjgr
懴	nfag
墾	eevf
築	tams
廧	yfwk
憲	pgln
觏	fjgq
鑦	qahm
悤	tlqn
桬	iits
颯	umtjn
匂	qxv
簤	tlmu
慽	ndht
侢	wgmf
蟎	jamyw
擑	rkbt
狫	qtfx
尻	nvv
湔	iue
欒	xyxs
㶓	iadt
霓	fvq
茟	avfh
䶠	dgkb
㝀	xgubf
刯	gjgj
謽	xkjy
趿	khey
諀	yrtf
譜	yuoj
趏	fhtd
㢾	xsfg
訋	yqyy
峳	mwht
箼	tngf
䏹	ehqn
犽	qtat
孌	xyxv
摘	rum
幝	mhkf
忐	hnu
抅	rqcyy
覶	ecmq
瑶	ger
忟	nyy
㲣	vhcn
腬	ecbs
王	gggg
蹢	khudb
隓	bdaa
䤎	sgck
魇	ddr
㩍	rtgi
粜	bmo
㹻	qttv
䕛	aydw
宥	pdef
㿤	rdwj
覠	vtkq
潩	ilaw
痩	ujhc
䑲	tehj
屍	ngqx
鐴	qnku
䠺	tmdkq
藼	apgn
㦳	fafdv
试	yaa
撮	rjb
蚊	jyyh
訨	yhg
䊊	ontn
镊	qbc
靁	flll
圪	ftn
嫕	vatn
吞	gdk
㺗	qtkf
蛱	jgu
憦	nool
惫	tln
忖	nfy
腹	etj
㺡	qtdhv
斥	ryi
諩	yuog
謩	ajdy
蔽	aum
臭	thdu
怬	nlg
讣	yhy
渂	ijyy
䵕	twid
䃊	daeg
笭	twycr
垖	fwnn
迀	fpk
邟	ymbh
㖳	ivkx
燵	ofup
瘲	utwh
㩥	rfag
㦩	nben
柣	srwyq
㣘	tqkg
䩹	afgh
竮	unua
脐	eyj
瓋	gump
躱	tmdsj
抌	rpqn
㨈	ryjg
㗕	kfjf
䊓	ojghw
醠	sgml
蚳	jqayh
兲	gwu
豯	eexdg
塥	fgk
酒	isgg
丈	dyi
俢	wtet
蜾	jjs
訄	vyd
呴	kqkg
猞	qtwk
㲹	imn
烌	owsy
㱥	gqft
醎	sgdt
辞	tduh
汱	idyf
䘼	pupb
峊	wnnm
哓	kat
滃	iwcn
㦈	nugl
炧	otbna
娹	vxyx
髰	dean
㮜	sanf
䶋	thly
啖	koo
䶳	wgkmz
徶	tumt
廑	yakgr
邦	dtb
绪	xft
膃	elwl
煖	oefc
洼	iffg
婐	vjsy
渶	iamd
錱	qggf
嘇	kcce
䥞	qryt
桁	stfhr
呪	kkqn
㚭	vdnn
淧	ipnt
少	it
乔	tdj
厖	ddnee
揙	rynao
䁤	humd
錊	qywf
䟐	fhdh
䃭	ddgn
敁	hkhc
眉	nhd
蕲	aujr
旈	yycq
韴	ujgh
铭	qqk
镛	qyvh
䕨	aeui
瞥	umiht
蹪	khkm
㚞	dssu
霃	fipq
窬	pwwj
蛪	dhvjw
鐏	qusf
鈶	qckg
濈	ikbt
㟫	mriy
迈	dnp
蛜	jwvt
丄	hgd
㜟	vnbt
亚	gog
埻	fybg
艍	tend
沈	ipq
泥	inx
砡	dgyy
䞖	fhay
粷	oqoy
撟	rtdk
泧	iant
灢	igke
爅	olff
件	wrhe
穵	pwnb
攮	rgke
蹱	khuf
蹘	khne
㾹	uhxs
榋	svvv
㔄	sojh
錀	qwga
㐠	ebnn
䂛	dcbh
讨	yfyj
絮	vkx
曥	jhalo
椔	svlg
咻	kws
怱	qryn
榆	swgji
鑧	qpay
汓	ibgn
堁	fjsy
贻	mck
毛	tfn
编	xyna
为	o
䏳	errh
酊	sgs
䆒	pwvy
坯	fgig
鐆	bueq
疔	usk
覆	stt
吖	kuh
㑤	walg
㸩	trfhi
櫍	srrm
兏	dhqv
蕐	agwh
腧	ewgjb
嘹	kdui
卛	xyxfu
况	ukq
賀	lkmu
䁲	hlmy
㮡	oansm
刋	tdjh
䘂	jfag
啼	ku
嵠	mexd
栠	wtfs
瞆	hkhmf
㮎	sgil
门	uyh
蚘	jdnn
䵞	lfojl
虥	hama
洢	iwvt
魏	tvr
侖	wgma
鐉	qnnwl
識	yuaj
㞽	mant
醪	sgne
笿	ttkf
迁	tfp
昤	jwycz
䃋	dwgj
衣	ye
勥	xkjl
稶	take
㘾	fpgf
䚽	ytfn
涃	ilsy
胝	eqa
䨵	fisj
㹾	qttkv
嬑	vujn
碸	dmtj
嗭	fhkx
昉	jynj
戹	ynnv
壁	nkuf
曹	gma
偁	wemf
䛲	yrmh
贙	hammk
䀢	htdy
㚛	dxjf
萎	atv
儬	wgeqe
袦	pubm
疤	ucv
巆	mook
弜	xxn
攠	rysd
擌	rtdw
㴈	irgm
苑	aqb
䁆	hdjn
玦	gnwy
疅	lglg
渥	ing
病	ugm
狻	qtct
蹜	khpj
檾	oopsh
諦	yuphg
倪	wvq
鏦	qtwh
㝼	dngf
捦	rqgb
酏	sgb
搯	revgf
㧒	rpwyv
衊	tlat
汋	iqyy
篵	ttwh
士	fghg
㸮	trwv
㺊	qtunr
弭	xbgm
焑	olsy
粐	oynt
茔	apff
彪	hame
皘	rgegh
瘮	ucce
籝	tyny
掜	rvqn
桞	sqbh
㞁	dnjx
巒	xyxm
禖	pyas
䖞	jfy
抇	rjgh
响	ktm
麯	swwa
厸	ccyx
隰	bjx
㝱	pnhq
䊙	dgao
衄	tlnf
披	rhc
墩	fybm
庺	ywcs
蘟	aben
螶	anjj
纥	xtnnw
撽	rrytl
㴄	ilwm
覢	oohq
咯	ktk
蛄	jdg
㠼	mhrhl
虓	vham
碔	dgahi
錉	qqaj
柧	srcy
郣	fpbb
䓍	ajfj
僋	wwymu
滜	irdf
㹿	qthje
薗	alfe
囐	khad
囡	lvd
茭	auqu
䩠	aftps
峿	mgkg
膭	ekhm
婺	cbtv
徖	tpfi
饿	qnt
㶫	duou
塤	fkmy
㴠	ibkb
畉	lfwy
勿	qre
䍀	xjtl
㫘	gijf
捜	rjhc
霗	fiwc
脌	erhf
皽	ylkc
怗	nhkgp
㵳	ipnen
擈	rogw
鍊	qgliu
禐	pyec
艫	tehld
㼫	jsgn
彩	ese
䒸	atlf
訷	yjhh
瞓	hykh
淁	iuvg
蝘	jajv
傖	wwyk
旺	jggt
嬂	vuaj
㶈	iooj
袡	pumf
偠	wsvg
岊	cmj
缓	xef
瘘	uov
蕞	ajb
㻅	gwfc
箷	tytb
䇸	tkgf
刾	guwj
䨧	fuwc
刪	majh
崹	muph
仼	wggo
㽢	ldjnz
坛	ffc
吱	kfc
郯	oob
㝒	pdfx
吙	koy
唘	dckf
琕	grtf
䞄	ytbm
堎	ffwt
汦	iqan
銾	qaiy
幔	mhjc
衅	tlu
兵	rgw
㚎	dbj
绶	xep
邷	gnyb
艑	teya
䁟	huda
䬓	mtjjn
扙	rdyy
䅚	tudb
僭	waqj
慵	nyvh
㖡	kywy
采	es
贤	jcm
杍	sbgw
舶	ters
敲	ymkc
逰	rtbp
撂	rlt
砨	dynn
醩	sggj
圡	fyi
峅	mcah
求	fiy
阮	bfq
拸	rqqy
鋖	qevg
㳮	iniy
䒰	aagf
猆	djdd
翍	nhcy
選	nnap
埪	fpwa
剨	dhdj
禑	pyjy
哵	kklj
阿	bs
豹	eeqy
翣	nuvf
沥	idl
朏	ebmh
卨	hmnk
狧	qttd
㳉	iegh
圜	llg
㡏	mhwjk
姗	vmm
訯	yeyy
䦼	bnwy
胕	ewfy
㤏	ntuy
䆃	utht
㑃	wxln
倜	wmf
貀	eebm
蟞	umij
醦	sgce
姸	vftf
稂	tyv
擅	ryl
孞	bnu
㾠	uqtg
任	wtf
㹖	TRUE
惷	dwjn
硪	dtr
㾤	upwa
偆	wdwj
乨	cknn
戊	dny
敗	mty
濵	ipnmr
㚽	agnv
绵	xr
帕	mhr
堘	fudf
霦	fsse
䏉	bjxo
疨	uaht
㪂	rnhc
粀	odyy
㔭	xjgh
吀	ktfhk
绥	xev
夣	yclq
迕	tfpk
䖺	whtjk
蔑	aldt
堥	cbtfa
搝	rthd
吲	kxh
苊	adb
计	yf
䴿	swwej
擎	aqkr
墁	fjl
蓯	atwh
衲	pumw
丗	gmk
鉁	qwet
峓	mgxw
蔒	avto
牊	thgk
左	da
蚞	jsy
䧀	bdcyj
掼	rxf
瓉	gfwm
樼	snbb
汸	iynu
䟗	khqah
䥺	qahto
幡	mhtl
垎	ftkg
膋	oope
䇎	uajg
织	xkw
嫚	vjlc
纡	xgfw
瞏	lfkel
府	ywf
旤	mnmq
跃	khtdh
醈	sgoo
㯖	sfln
萊	asww
䆕	pwnw
姉	vgmh
猷	usgdl
㜩	vtmd
喬	tdkk
嚰	kysd
浵	imye
嗂	kerm
㥞	nuey
濺	imaa
酫	sgwg
聍	bps
儇	wlgeu
莕	askf
喊	kdgte
㓍	uycq
䖼	jfcb
㶰	oafgw
抐	rmwyb
勹	qtn
豸	eer
黃	agmw
攵	ttgy
䔤	ardj
蛥	jqqy
贐	mvhl
㧜	ramh
击	fmk
䍔	ldcu
賫	fwwm
僐	wudk
屾	mmh
胪	ehnt
侹	wtfp
毹	wgen
孆	vmmv
㽚	lrhj
諞	yynay
渣	isjg
焎	rrou
蕃	ato
謆	yynn
诹	ybc
媬	vwks
稕	tybg
䜙	yjxo
襵	pubbv
叫	kn
歮	hhhf
臺	fkpf
霡	feyi
䩶	afbj
徎	tkggb
㗷	kpfm
苓	awyc
龬	龬
疾	utd
熯	oakw
抓	rrhy
莝	awwf
䵉	yssj
嘓	klag
榘	tdasm
捌	rklj
糟	ogmj
潥	isoy
账	mta
曘	jfdj
賁	famu
呵	ksk
礚	dafl
泖	iqt
恄	nfkg
洲	iyt
徝	tfhg
诓	yaggu
黛	wal
柭	sdcy
蝇	jk
㯐	bdas
認	yvyn
辝	ckuh
缶	rmk
敬	aqk
暴	jaw
队	bw
扡	rbn
覑	thgqc
䤹	qpoc
銐	gqjq
淦	iqg
忳	ngbn
磊	ddd
跑	khq
㡉	mhxx
筥	tkkf
茀	axjj
痰	uoo
㽺	ueyip
抛	rvl
盻	hwgn
铸	qdt
䧎	bkeg
挅	resy
錜	qwyn
剪	uejv
聟	tdkb
仂	wln
鬁	detj
䅓	tqkc
语	ygk
秢	twycx
鍅	qifc
園	lfkeq
隦	bnku
婝	vpgh
耼	bmfgl
䘀	wnnjq
鬃	dep
髿	deity
岪	mxjj
缨	xmm
㴪	iths
掽	ruog
烖	faoi
㛢	vten
䭫	xjuh
翅	fcn
帞	mhdjl
拰	rwtf
麦	gtu
踗	khwny
㛘	vfpb
䅎	tten
㐹	wrnn
橣	spne
夺	df
踇	khtu
喳	ksj
䠛	khem
㚦	vgjh
䣉	iitc
撁	ryxh
摄	rbcc
㐡	vdmdi
旖	ytdkz
㖵	khwy
捊	rebg
樂	xrxs
坭	fnx
㹗	trff
䅼	tjlc
側	wmjh
䐕	ekbg
鈛	qat
琾	glwj
甸	ql
箪	tujf
酣	sgaf
枘	smw
撢	rsjh
踕	khgh
鋭	qukq
霩	fybb
彫	mfke
丆	dgt
螛	jpdk
壙	fyaw
裌	pudw
怼	cfn
訃	yhyi
澫	iajy
椫	sujfy
䀖	hgdy
锬	qoo
腡	emnk
粈	onfgu
掆	rmum
毡	tfnk
㣵	tfup
丢	tfc
赻	fhit
遂	uep
㧁	ynfc
扖	rtyy
㱱	gqrc
腚	epg
瀲	iwgt
㿺	jawci
賐	mcwt
㚚	dqkf
㟢	mdsk
鐽	qfup
刵	bjh
䗗	jtgaw
瑉	gnaj
㿊	uaqj
傃	wgxi
䤦	qwat
嗑	kfcl
鏭	qton
痓	ugcf
燆	otdk
㴳	ifde
㬛	jwgn
惩	tghn
䩫	afgy
邈	eerp
榓	sntl
㴬	itmf
眼	hv
夻	dkf
䣓	gkmb
㖤	kbib
㚂	fgke
猋	dddu
佣	weh
荓	auaj
㕷	krg
雼	fdfm
嬬	vfdj
绗	xtfh
䙽	duhq
砻	dxd
莨	ayv
蹺	khfq
罂	mmr
㝿	dnhc
㓱	wgej
抱	rqn
裧	puoo
獢	qttks
蜡	jajb
屷	men
㞙	ntfi
諬	tdny
㸳	trwcc
㱙	gqgn
唆	kcw
㗾	kafx
闩	ugdd
戈	agnt
肿	ek
䪞	gddg
㳃	ivfh
诠	ywg
痈	uek
绮	xds
簃	ttqq
䴵	swwaq
狃	qtnf
㞾	mnxn
衰	ykge
嵴	miw
摦	rdfy
兀	gqvc
䃅	dujfp
㽾	ubmk
厌	ddi
䖆	asge
溻	ijn
鉼	quah
邴	gmwb
妡	vrh
蛏	jcfg
诿	ytv
彵	tbn
鉷	qawy
庑	yfq
螨	jagw
夠	qqqk
熋	cexo
錓	qudn
轩	lf
脞	eww
碕	ddsk
濫	iahl
㘮	fnyy
鬅	deee
硙	dmnn
子	bb
捏	rjfgf
䣆	gvab
訽	yqkgh
蜴	jjqrz
隌	bujg
梄	ssgg
瑰	grq
斊	ybfo
䥄	qdaj
瞸	haas
尩	wqgd
她	vbn
搊	rqbtz
仚	wmjn
㿢	jerf
䢨	twwp
箦	tgmu
魄	rrqc
枂	seg
齜	hbhx
捩	rynd
㧞	rtdc
㪿	btbr
㐕	mnb
伓	wgiy
磎	dexd
距	kha
囲	lfjk
㗏	kgih
伹	wegg
飆	dddjl
胬	vcmw
摞	rlx
妸	vskg
㢫	xmh
钍	qfgd
潷	itvh
晀	jiqn
冗	pmb
伧	wwbn
痙	ugva
碑	drt
丬	uygh
忢	gnu
缐	xriyx
潜	ifw
㱦	gqdk
锒	qyveb
讟	yfly
爹	wqqq
㣠	thtu
㷹	oahj
䭬	xjvh
胊	eqkgi
堉	fyce
䂔	tdffl
钽	qjgt
腿	eve
䵋	amwe
楋	sgkj
苙	aufc
崻	mtff
㘋	kahm
贓	mdntl
筭	tgajo
髭	dehf
㩜	rahl
䑿	tepj
乍	thf
躒	khxs
傫	wlxi
濦	iean
㐨	cbcb
棐	djds
䞶	fhjr
耍	dmjv
㣦	ttvg
蛬	awju
黸	lfolt
行	tf
桌	hjs
㜽	vbf
㞫	mpu
謾	yjlc
乢	mnn
度	ya
䴹	swwse
徠	tsww
瀦	iefj
晇	jdfn
隭	bfdj
储	wyf
䈟	tmjj
䒨	atdu
赃	myfl
落	ait
薏	aujn
傤	wfalc
㫝	jqay
㶜	inuj
湻	iyjg
蝰	jdff
㩘	rugt
肂	gqvhu
屐	ntfc
萮	awgjn
括	rtd
㓺	hayj
䂣	dhxn
墦	ftol
叻	kln
佼	wuq
窄	pwtf
旛	yttl
備	wate
鄓	thdb
稺	tnuh
敏	txgt
璪	gkks
孺	bfd
昢	jbmh
䓕	afqp
芁	amb
齺	hbqt
櫟	sxrs
㝨	pfke
儲	wyfj
犹	qtdn
偤	wusg
䢀	ltnn
䥍	fufq
茰	ajqu
㺕	qttl
秊	ttfjt
舟	tei
狄	qtoyv
㩃	rpfu
䁼	hlff
䤅	sgwj
藍	aahl
䏍	cef
檻	sahl
靴	afwx
饫	qntd
樌	sxfm
跚	khmg
皿	lhn
匙	jghx
享	ybf
䠶	tmddx
蓲	aakk
掩	rdjn
茺	ayc
嘥	kthh
忠	khn
蘃	ahhs
嗇	fwwk
涡	ikm
甯	pne
樨	snih
荎	agcf
湚	itxn
董	atg
蠰	jyke
㖾	kkut
浺	inkh
㿬	hccn
膚	hale
冦	pfqc
㲑	tfnir
標	ssfit
㳓	idkg
㨚	raqj
㫰	jyve
曙	jl
寋	pfjb
氝	rnmw
罆	rmxm
馆	qnp
暀	jtyg
茳	aia
娗	vtfp
塓	fpju
碭	djgr
嘋	kftt
摷	rvjs
䥬	qagfp
恻	nmjy
揑	rvag
娇	vtdj
呤	kwyc
螲	jpwf
垽	irff
堻	ivff
㘧	fcbhp
茋	aqay
踹	khmj
烵	oaqy
肐	etnn
蹖	khdv
䂦	dwet
择	rcf
髸	deaw
慹	fufn
棻	awvs
汬	fjiu
盉	tlf
罤	luxt
㟸	mrdf
䖻	jycq
楿	stjg
䨌	ffqb
䞥	fhde
燔	oto
跤	khuq
斩	lr
瓆	grrm
状	udy
桵	sevg
哢	kgahs
毩	tfnof
鑘	qlll
噧	kajy
膏	ypk
㣋	fjye
䝊	egvh
焋	nhdoa
栝	stdg
挏	rmgk
哖	krhf
榦	fjws
貖	eeul
䣎	vlbh
怯	nfcye
禛	pyfwt
夲	dfj
䜕	yajy
虹	ja
廮	ymmv
㼘	mgnn
啡	kdj
绔	xdf
矧	tdxh
羞	udn
薑	aglg
殚	gqu
爙	oyke
鎝	qawku
暢	jhjr
插	rtf
羧	udct
躁	khks
涫	ipn
娡	vfny
媟	vans
堄	fvqn
廻	lkpd
嵛	mwg
漅	ivjs
槪	srxq
诖	yffg
䠇	khnm
䅃	amyt
捽	rywfg
氶	bii
呠	ksgg
厪	dakgp
掚	rgmyh
荾	acwt
拥	reh
渡	iya
鈤	qjg
薛	awnu
霼	ffco
剺	fitv
唙	kqto
喴	kdgt
痣	ufni
哙	kwfc
䥖	qusd
㷄	ojsy
㹮	qtdjs
坅	fwynb
䖦	jbmhh
梀	sgki
霵	fkbt
熫	oyao
耝	dieg
憥	oopn
蹐	khiew
猭	qtxe
懍	nylt
香	tjf
诪	ydtf
黟	lfoqb
搃	rukn
褕	puwjw
詃	yyxy
跾	whth
楙	scbs
䗕	pqbj
褺	fufem
贒	ahnmw
觇	hkm
賰	mdwja
褪	puvp
㧯	rftx
晤	jgk
呫	khkg
檣	sfwk
䯩	ymkcb
圁	lyd
㗊	kkkku
冻	uai
嗻	kyao
倨	wnd
悑	ngey
䠝	khkmx
蒵	aexd
鬀	deut
䇡	tpsj
坢	fufh
卞	yhu
杫	shg
壀	fnku
霬	flaw
玄	yxu
㹀	trfb
牮	war
䜣	yrh
夁	flld
袺	pufk
㕣	wkf
靺	afgs
稝	teeg
抗	rymn
坫	fhkg
丩	nhk
謹	yakg
䑳	tewa
依	wye
浃	igu
譑	ytdk
㫯	jjgq
㑪	wyjgn
公	wc
敄	cbtt
羹	ugod
繤	ahdi
㨺	ramy
辷	gpdw
礷	daal
牔	thgfu
裢	pul
焄	vtko
㩝	rype
禇	pyfj
邖	mbhc
豱	ejlg
赒	mmfk
脋	vvve
鋂	qtxu
蝚	jcbs
榞	sdri
㟱	mugo
枨	sta
諂	yqvg
㪔	sshc
睸	hnhg
謮	ygmy
懟	oguns
尵	dnkm
祁	pybm
念	wynno
瑾	gakg
苏	alw
噪	kkks
䧘	bxey
秣	tgs
君	vtkdw
燖	ovaf
绁	xanns
錖	hicq
耏	dmje
昮	jalb
諿	ykbg
挵	rgah
诫	yaah
螃	jup
踍	khfb
鈌	qnwy
蕍	aiwj
㚕	dxjj
芞	arnb
诉	yr
䍕	lqayv
荖	aftx
菱	afwtt
奆	danf
蒜	afi
㽭	lfdjg
萉	aecb
躀	khxm
㱝	gqxl
䛞	yjfh
敹	hptt
釩	qmyy
抧	rkwy
銔	qgif
粙	omg
恽	npl
㪃	skhc
箖	tssu
剉	wwfj
早	jh
週	mfkp
毫	ypt
䈳	tjnf
糁	ocd
䠯	khwaj
璣	gxxt
贁	mmty
蝛	jdgt
嚸	klfk
憄	tfhn
山	mmm
挱	riit
湫	itoy
帓	mhgs
盲	ynh
诋	yqay
蚃	xtju
耟	dian
厇	dtav
㕶	kgg
乸	bxgu
堭	frggu
逻	lqp
澷	ijly
䰄	deln
龠	wgkad
迂	gfp
葴	adgt
宆	pxb
屲	tmj
㛆	vesy
濮	iwo
㥱	nadd
阡	btf
炬	oan
奜	djddh
鞒	aftj
慆	nevg
绅	xjh
惖	jqrny
另	kl
蟊	cbtjp
佯	wudh
㧰	rqiy
韸	ujth
蹠	khyo
燙	ijgo
裀	puld
陁	btbn
醃	sgdnt
塑	ubtf
桰	sqak
狠	qtv
踨	khwh
岆	mtdy
唐	yvh
琢	gey
簳	tfjfy
芅	aau
扈	ynkc
禴	pywa
䈻	tegy
庐	yyne
爘	ohqe
㴣	iigw
冒	jhfn
㫞	jbhc
㕀	mbb
㢩	xqyyh
㚋	qqmk
鞓	afkg
㵻	ievc
㿪	hcvy
䓉	aahb
珿	gkhy
䑜	tdas
䅾	taqj
弌	agd
熐	opju
伀	wwcy
棞	slty
埁	fmwn
国	l
萅	agbj
稅	twkq
吽	krhh
胞	eqn
农	pei
脦	eany
翛	whtn
敔	gkty
倚	wds
酯	sgx
玘	gnn
悘	atdnv
扰	rdn
㰆	gkhsj
砙	dgnn
渃	iadk
圂	lei
淬	iywf
辢	gkiu
樷	ssbc
塣	ikgf
慟	ntgl
有	e
㽠	ldww
栣	swtf
汝	ivg
魆	rqctn
㤬	nffg
韹	ujrg
㤰	wthn
躮	tmdvu
蛻	jwkq
痊	uwg
蛙	jffa
䀮	hynq
靚	gehq
胤	txenx
䟈	fhfg
貞	hmu
肺	egm
涨	ix
愀	nto
僕	wogy
鞵	afed
㸗	wqmk
䛯	yndg
患	kkhn
畸	lds
則	mjh
统	xyc
鞞	afrf
㴼	ipwj
慀	nexd
廷	tfpd
楑	swgd
壗	fvhl
园	lfq
稥	tojf
魂	fcr
荲	ajffa
箒	tvph
㶲	oeh
䃡	daqj
㤉	naht
墣	fogy
棔	sqaj
拼	rua
崰	mvlg
隨	bdap
䩛	afnt
䤷	qajv
鑷	qbbb
䞉	mudm
耖	diit
玞	gfwy
㬈	jjlg
苨	anxb
哗	kwx
氃	ujfn
舍	wfk
扭	rnf
撇	rumt
㕃	dgak
㸇	ofwm
莐	aipq
㔱	avwi
脛	egva
平	gu
苲	athf
褊	puya
瓖	gyke
䃓	dfjf
㛣	vkmyv
剚	gkvj
㗐	kdyl
㙙	idnf
䇂	uhk
鎬	qymk
鋧	qhqn
欕	skkt
燾	fnao
訒	yvyyy
逾	wgep
咆	kqn
玿	gvkg
酶	sgtu
疠	udnv
栿	swdy
揥	ruph
䘩	puqj
徘	tdjd
踡	khubi
笏	tqr
亿	wn
冘	pqv
姀	vty
庠	yudk
鑏	qpns
怘	dnu
鋽	qhjh
㦄	yssn
䉵	thde
森	sss
邑	kcb
狍	qtqn
痠	ucwt
伶	wwyc
止	hh
裐	puke
钓	qqy
䔢	awwn
踩	khess
穸	pwq
吟	kwynv
藎	avhl
瓫	wvgnr
肁	ynvh
袲	yqqe
動	tgjl
葵	awg
黂	yssm
䟏	fhxs
冴	uahtf
䂬	amyd
㳨	ivgq
㾖	ujfd
历	dl
翩	ynmnx
隂	bwdy
䭲	tjdk
䝒	ebci
喣	kqko
戋	gggte
溎	isffk
㛥	vijgs
醻	sgff
櫿	sooki
棕	sp
纳	xmw
企	whf
䧜	byvk
聃	bmfg
孡	bckg
撡	rccn
㟶	mdrih
㪰	you
箵	tith
汇	ian
湇	iueg
肜	eet
紮	snxi
䏮	eliy
置	lfhf
祂	pybn
激	iry
鋐	qpdc
褻	yfwe
辏	ldw
畕	llf
㕲	ksy
㑱	wcbs
儵	whtoa
鍷	qdffn
岐	mfc
艇	tet
亶	ylkga
嫮	vffnq
啶	kpgh
橫	sagw
㯧	sfhk
纍	llli
馚	tjwv
濨	iuxn
捶	rtgfs
操	rkk
捆	rls
聇	bghg
藡	aump
䚸	ywjh
譯	ylff
黠	lfokb
刞	egjh
昭	jvk
庤	yffi
䣜	haeb
濸	iawk
诙	ydo
鍢	qgkl
亰	yjiu
㹪	qtmgz
乽	ftjn
榬	sfke
裥	puuj
瓰	gnyv
陕	bgu
媢	vjhg
猡	qtlq
淅	isr
隕	bkmy
陸	bfwf
贆	mddd
纨	xvyy
鉔	qamhb
且	eg
囘	mnv
㟋	mukq
䨞	ftkyj
尭	faqb
挸	rhqn
稢	takgn
堺	flwj
笛	tmf
呰	hxkf
袧	puqk
拭	raa
勅	gkil
结	xf
诂	ydgq
往	tyg
㧚	rgnn
竚	upsh
寓	pjm
尦	wqqy
䞢	fhtf
养	udyj
䙡	pukma
㓑	ufuf
酭	sgde
蚾	jhcy
迗	gdpi
腟	epgf
䋯	ynai
嘂	kknk
賳	mfak
筙	tdiu
䕏	augt
更	gjq
㗍	ktjg
幊	mham
褢	yrqe
鑅	qoos
䬇	ukqj
涾	iijg
跏	khlk
前	ue
㶢	ovb
酿	sgyef
鑲	qyke
達	fudp
䑉	eyny
惇	nybg
匰	akkf
鐈	qtdku
蘄	akkr
䂨	dryy
嬛	vlge
廁	ymjk
鑢	qhan
㐈	tynbq
亟	bkc
膌	eiwe
㑓	wcdc
椻	sajv
妫	vyl
㐴	wqy
䍧	trudm
蒿	aym
㜱	vrrm
㸿	trfm
妏	vyy
汊	icyy
扦	rtfh
惛	nqaj
聨	bxxa
镚	qmeep
椠	lrs
㛚	vceh
栗	ssu
䍐	lfj
摿	rwuj
墿	flff
䐃	elty
㜄	vmtj
榈	suk
雽	ftuhd
襌	pukf
涆	ijfh
㼔	jlry
䫻	mtjjb
俪	wgmyi
嶛	mdui
蘨	aeri
㘝	lcin
䙥	pufca
䓁	affu
埚	fkm
滢	iapy
宫	pk
祸	pykw
犦	trji
避	nk
嶽	mqtd
葿	anhfn
鋻	ahnqw
䨣	fafjf
伙	wo
偹	whtl
䄓	pyrg
劮	rwln
铜	qmgk
樅	stwh
惈	njsy
蠌	jlffr
漽	inih
磨	yssd
砽	deh
硶	dmwn
旱	jfj
䪋	afkp
㶦	ocbh
䎚	ndhnq
谭	ysj
珪	gffg
皀	rxb
佡	wwmh
揉	rcbs
椘	sspu
䧪	bydv
䛢	ytmnp
奟	deef
䵣	lfog
諣	ymnkq
伔	wpmnh
覯	fjgql
壇	fylg
樠	samyt
倊	wwcn
篩	twnh
祡	hxfi
嵒	kkkm
嚢	gkhe
䊅	oqkg
㻟	gdae
蠾	jnij
杤	sdnn
嗆	kwyk
喧	kp
枝	sfc
鋇	qmyh
㢌	ybsk
㙓	ffff
䵎	amwj
防	by
鎣	oopq
桡	sat
䈋	tijf
䏛	equg
殉	gqq
渢	imtj
践	khg
缕	xov
杈	scyy
龳	龳
湕	ivfp
嚑	ktgo
惍	nqg
㭔	stuh
冄	mfdr
坥	fegg
㫥	jqkgp
娚	vlln
腌	edjn
跥	khes
糕	ougo
嬆	vwgn
粪	oawua
茄	alkf
㰏	styk
磸	dusd
悳	fhnn
舒	wfkb
㐋	fnb
䤏	sgdr
琦	gds
鈱	qnan
䈠	tefcy
婞	vfuf
㥛	nbkg
侨	wtd
燳	ojvo
臿	tfvd
倉	wyvkc
淲	iham
䈤	tsaf
创	wbj
㥊	neeg
膹	efam
酥	sgty
桠	sgog
魉	rqcwi
黬	lfotq
撙	rus
灼	oqy
跹	khtpa
髲	dehc
缂	xafhm
螤	yjjw
氄	cbtnv
㘀	kvoy
墛	fnff
号	kgn
殤	gqtru
塛	fssy
劎	wgkv
褑	puec
䈁	twgah
蚈	jgah
䀴	hgva
㿇	unrd
憛	nsjh
㙀	fpwv
介	wj
麧	swwnc
寎	pnhw
惣	trqn
瀢	ikhp
褯	puyh
㭴	sjcf
㱪	gqnj
瘯	uytd
䩞	afhk
䎐	fjng
慏	npju
胓	eguh
俺	wdjn
冹	udcy
视	pym
䉘	tspi
窸	pwtnt
仌	wwu
鞋	afffi
霟	fiaw
釺	qtfh
䤓	sgae
釨	qbgw
貃	eerg
沖	ikhh
竕	uwvn
淃	iudb
䖌	hamjt
贵	khgmd
妋	vfwy
焾	owyn
堯	fffqg
䘖	trmh
髳	dect
林	ss
江	ia
姴	gqjv
㢹	xuh
窮	pwtx
畝	ylqy
狏	qttb
訖	ytnn
㞚	ntfv
區	akkki
氤	rnl
䫹	mtja
㓕	udgt
耆	ftxj
勍	yiln
䗚	jgef
矵	djhp
姾	vwgg
书	nnh
购	mqc
圑	lgef
㵇	itdf
钲	qghgv
衔	tqf
矤	xtdy
呔	kdyy
濼	ixrs
䍙	ltxu
喆	fkfk
悓	nhqn
㳹	isggz
䯵	defa
箋	taar
㕖	cccsl
可	sk
㾱	uwfq
肣	ewyna
吜	knfg
喺	kwti
埄	ftdh
佾	wwe
㓯	vljh
䘵	puvi
趘	fhnny
戶	rnd
䁇	pnth
鄕	xtrb
淂	ijgf
芵	anwu
辿	mpk
盫	wgklz
梎	srxn
苵	arwu
腷	egkl
䎊	tkng
鉒	qygg
㼜	mdgn
簀	tgmuj
聒	btd
㳗	icyf
户	yne
嚹	krmh
扔	re
疩	uvfk
愕	nkk
暓	cbtji
俠	wdww
躲	tmdsm
叟	vhc
謝	ytmfw
䓟	amfk
棙	synd
冢	pey
䉔	tgqa
乣	xnnc
䉽	oufh
㧃	rnhh
湉	intd
䨷	fssc
㮬	swcn
羒	udwv
謐	yntl
辻	fpkm
䜥	yjgp
䩯	afbg
㓘	mgqy
䈪	tgkh
梭	scw
犚	nfih
䅅	tffgw
萌	aje
浽	ievg
唴	kudn
荮	axf
亂	ecmn
䛱	ykhn
樬	stln
莯	aisu
槭	sdhtb
㶤	oqyn
侱	wkgg
圳	fkh
倮	wjs
沮	ieg
舷	teyx
黣	lfou
㴩	ivkc
祄	pywj
搞	rym
䟹	khef
窝	pwkw
曠	jyaw
礓	dgl
共	aw
亵	yrv
醘	sgfl
锋	qtd
祒	pyvk
畓	ilfr
棗	gmiiz
滧	iuqt
圔	lfcl
潛	iaqj
䗹	juxn
㲠	fitnr
肘	efy
耕	dif
幭	mhat
篅	tmdjw
祦	pykd
篇	tynav
瞩	hnt
㪚	ajty
椱	stjt
莎	aiit
䔴	abmc
洋	iu
㪝	glic
䑤	tewnd
泞	ips
叄	cccd
萭	atky
呬	klg
污	ifn
㾽	uwnp
㣩	tssy
㿳	hcvl
醚	sgo
茗	aqkf
姍	vmah
忎	tfnu
峠	mhgh
漷	iybb
䝡	eeay
槆	saqj
諔	yhic
㴹	iopy
㞹	mskg
厯	dssn
㸰	trpx
愧	nrq
㠉	mujf
耤	diaj
㼿	ujfns
浬	ijfgo
䏟	entt
㟷	mawk
蕠	avki
鉌	qty
埥	fgeg
粘	oh
煫	ouey
撺	rpwh
褶	punr
镱	qujnm
䐯	elxi
熭	dhdo
愆	tifn
䅬	tuwl
定	pg
筆	tvfh
捳	rrgm
尫	gqgd
枚	sty
㟥	mcde
蛞	jtdg
㒩	wxej
鈣	qghn
栜	sgmi
居	nd
檺	sype
鎆	quej
皑	rmnn
叒	cccuf
砆	dfwyw
燄	qvoo
畐	gklf
狗	qtq
菤	audb
皕	djdj
躸	tmdkm
齫	hbls
棷	sbcy
痛	uce
枯	sd
趠	fhhj
罣	lfff
坨	fpxn
䨸	fben
櫨	shalz
䅉	tgog
藁	ayms
䂓	tdhq
籦	tqtf
铀	qmgb
䙓	pulc
埕	fkg
偏	wyna
殗	gqdn
帗	mhdc
臊	ekks
䥙	qbue
涪	iuk
擰	rpns
郢	kgbh
袼	putk
玗	ggfh
䟨	khna
摳	rakk
㺹	gcah
挭	rgjqd
䘢	pups
聤	byps
噉	knbt
韨	fnhc
㞅	dnjs
㫻	jwga
篺	trrf
榠	spju
穁	tabg
敃	naty
柤	segg
聊	bqt
谥	yuw
缷	rmbh
䊣	oamwu
璚	gcbk
㺋	qtwn
㭊	sthn
籺	otnn
氆	tfnj
㭞	sitl
檃	beas
拜	rdfhr
缌	xlny
猬	qtlea
溛	ipwy
占	hk
芊	atf
䏠	eug
㖻	kcbs
铴	qin
笋	tvt
鈝	qrhh
㯝	skhk
粭	owgkj
匱	akhmy
䤍	sgay
毸	tfnnr
渖	ipj
奵	vsh
濇	ifwk
藯	anfn
厷	dcut
蚵	jsk
陚	bgah
遈	jghp
囨	lgii
淑	ihic
趝	fhwnd
惗	nwynv
㒽	judbq
供	waw
製	rmhe
蔂	alxi
軀	tmdk
荆	aga
䛤	ykhy
忸	nnf
筏	twa
䓖	apwl
䄣	pyfm
擐	rlgeh
痧	uii
朄	jhgi
夛	vqu
洭	iagg
畳	lpeg
勃	fpb
嫁	vpe
梜	sdww
歴	dssha
密	pnt
齶	hbkn
徬	tupyh
㜇	vffn
伴	wuf
㽵	ufd
髞	ymks
掖	ryw
由	mh
䔃	apyg
㡿	yubt
䘺	puphq
陬	bbc
䧈	bsg
謑	yexd
夷	gxw
敿	tdkt
礇	dtmd
㕩	kdhh
㱜	gqhy
萬	ajmy
䇏	uybg
瀗	ipdn
聫	bxxd
夋	cwtu
鬎	degj
䑽	tejn
郦	gmybm
㪣	ymkta
炋	ogiy
㺚	qtfp
䖛	hami
䧨	bogw
冣	pbcud
玖	gqy
棧	saat
䓣	agmy
咼	mnmk
镎	qwgrm
䢣	qypd
轹	lqi
實	pxfm
崦	mdj
萙	aspq
恤	ntl
砏	dwvn
遳	awwp
市	ymhj
匨	anhfg
梡	spfq
枤	sdym
茴	alkfk
鋪	qgeys
烺	oyve
蝃	jccc
螥	jwykt
汼	irhh
壒	fafl
猂	qtjf
鈕	qnfg
習	nrf
叝	fcbc
巎	mdht
㛿	vgkh
孹	nkub
郉	ftfb
枽	fasu
脓	epe
潡	iybt
臉	ewgw
㻄	gtgh
缊	xjlgz
冟	prxb
燱	oujn
貢	amur
鑂	qtgo
冞	pou
芙	afwu
菝	ard
蛣	jfkg
䐱	eumd
㽖	llna
忏	ntfht
㞪	vmj
㙍	fccc
笌	taht
㩼	qqfc
再	gmf
鈋	qwxn
仵	wtfh
辥	btwu
㶱	osgg
泟	ighg
㟡	mudb
棡	smum
砰	dgu
㝓	pwgk
蹋	khjn
艨	teae
䕅	avvc
揆	rwgd
㘏	uthxu
鐌	qqje
俐	wtj
舦	tedy
䉥	trtnp
螈	jdr
㚢	wvg
憼	aqkn
圭	fffz
贫	wvm
㷨	omth
㼁	gugt
鑑	qahl
炄	onfg
睷	hvfp
帻	mhgmz
䯶	deeg
䐶	eaqj
讦	yfhi
鈨	qfqn
幂	pjd
陃	bgmw
溢	iuw
晛	jhqn
俤	wuxt
趹	khnw
梶	sntn
峇	mwgk
棂	svo
㙕	fleg
㑝	wgah
銺	nhdq
匳	awgw
鬹	fwhh
怜	nwycq
夢	alpq
铋	qnttc
宦	pah
偃	wajv
㚩	vmfg
埴	ffhg
辑	lkb
櫔	sday
弋	agnyk
村	sf
瞙	hajd
㩊	relf
訠	yxhh
罔	muy
讓	yyke
梁	ivw
价	wwj
潳	infj
捴	rwcnr
屭	nmmm
䃒	dgkh
䬞	mtjf
㩄	rmln
謓	yfhw
聬	bwcn
肊	enn
忼	nymn
箰	tqjb
氫	rnga
缰	xgl
聥	btky
釛	qlnx
寨	pfjs
娶	bcv
㑹	wgmjr
匪	adjd
颱	mtjk
薂	aryt
琶	ggc
屈	nbm
鈈	qgiy
炦	odcy
儣	wyaw
㜸	awnvb
秫	tsy
酡	sgp
竀	pwgq
刺	gmi
䵯	lfofk
瞶	hkhm
粓	oafg
傢	wpey
庶	yao
楊	sjgr
菷	avph
劻	agln
掉	rhj
㮻	scyj
䠣	khnwx
䠟	fufhj
婦	vvph
姚	viq
罛	lrcyi
燸	ofdj
澊	iusf
则	mj
怾	nkwy
䍓	laht
䃥	dujfx
湶	iriy
韱	wwag
猊	qtvqj
齇	thlg
㟌	mdne
㟗	wvwm
躭	tmdq
㟵	mlgh
圊	lged
誓	rryf
髼	deth
夤	qpgw
㨒	rdffl
獚	qtaw
醳	sglf
䒡	axhj
儆	waqt
䏰	evyn
璖	gias
㟚	sfcm
賧	mooy
磯	dxxt
裮	pujj
愅	nafh
寙	prcy
㠁	mcce
靓	gem
団	lfi
蠃	ynkyz
抉	rnwy
䂍	cbtid
㴕	iaty
珜	gudh
刃	vyik
講	yfjf
蝮	jtjt
哳	krrh
牂	nhddc
参	cd
烷	opf
蛳	jjgc
坺	fdcy
熢	otdp
鉚	qqtb
䤾	qevgc
㷮	ogmjv
囮	lwxvl
悙	nybh
檭	sqve
刏	rnjhp
匊	qoid
叼	kng
讹	ywxnx
坦	fjg
䩧	afyg
儔	wfnf
斨	nhdr
蕀	agmi
哈	kwg
銢	qfiyk
抋	rny
砦	hxd
煄	otgf
㑚	wvfb
㬚	jyct
斶	rlqje
圖	lkfk
㨲	raps
煵	ofmfz
㹅	trqnk
勨	qjel
㮏	ssfi
伮	wvcy
䤡	qmfg
撣	rkkf
牥	trynw
桖	stlg
堸	fmtj
琚	gnd
氘	rnj
辡	uuh
剔	jqrj
睠	hudb
斍	yhqb
啈	kfuf
胎	eck
苋	amq
㖠	kdfi
墧	ftdk
玍	tff
锢	qldgs
肎	pef
㟂	mxgu
幢	mhu
崳	mwgj
牽	yxph
㖥	klty
㑲	wfmf
苆	aavb
沜	ithn
盞	aalf
崮	mld
䊏	oooy
幟	mhuj
聿	vfhk
鍓	qkbg
刦	fcjh
冩	pvqoh
䣸	wtfg
裄	puth
咋	kthf
赽	fhnw
棼	ssw
訐	yfhm
朿	gmiik
煏	ogkl
猼	qtgf
虾	jghy
㓙	ybka
辭	ecmu
帅	jmh
晅	jgjg
塀	fnua
曆	dttj
垺	febg
岴	mrggx
鎡	quxx
旎	ytnx
傘	wwwfy
䟰	khthe
銰	qaqy
钵	qsg
䛶	ydhs
嬖	nkuvm
碛	dgm
逘	ctdp
宭	pvtk
蚅	jdbn
厺	dcu
䠏	khwd
痔	uffir
枱	sckg
䔜	abmf
洧	ideg
悈	naah
嫴	vduh
嘙	kihv
廋	yvhc
绬	xamdr
悸	ntb
棝	sldg
暚	jerm
㝉	pgf
䧐	bybg
萝	alq
祓	pydc
䰚	gkmy
㾀	ufci
弃	yca
龹	龹
佞	wfv
脥	edww
叁	cdd
詩	yffy
黙	jfdo
汵	iwyn
矬	tdw
煤	oa
恪	ntkg
並	uogf
碽	damye
課	yjsy
釹	qvgx
玱	gwbn
跗	khwf
轪	ldy
肙	kef
瓠	dfnyw
第	tx
矂	hkks
㙤	fhah
䀗	hnwy
诸	yft
㟩	natm
匧	adwwa
謅	yqbt
蓃	avhc
捉	rkh
㑥	wjqr
唹	kywu
支	fc
䂳	dwwf
梳	syc
霛	fxxx
纛	gxf
㡥	mhen
樦	styg
䐠	eayq
肯	he
牷	trwg
艗	teul
瑤	gqrm
蒴	aub
椰	sbb
袥	pudg
萤	apj
税	tuk
䩙	afyx
翉	sgng
陨	bkm
佻	wiq
扢	rtnn
犛	fith
䘆	jpdn
萣	apgh
恀	nqqy
鎽	qmth
菔	aebc
㿒	ufnf
旂	ytrh
久	qy
稞	tjsy
獳	qtfj
钪	qymn
彁	xskk
㧽	rldg
樲	safmy
蝶	jan
䞩	fhwkd
卢	hn
㚗	degfs
崱	mmjj
眪	hgmw
牏	thgj
佁	wckg
烜	ogjg
㕅	dlku
姨	vg
弚	uxhjm
㽨	luda
㵭	ifto
諴	ydgt
㸂	uepo
貚	eekf
㾰	uded
摭	rya
侎	woy
䃞	ybvd
穔	tamww
苄	ayh
滮	ihae
多	qq
权	sc
虶	jgfh
勳	tgllg
証	yghg
䍘	lou
㷌	ovph
礣	dalt
苁	awwu
梙	skkh
殨	gqkm
穝	tjbc
㢴	xlry
术	sy
翔	udng
㣣	tdww
蹧	khgj
䖟	ynju
䍴	udtv
㔏	dddj
壢	fdthv
䢛	mwkp
㭋	sdhhf
莉	atj
㪌	cehc
洽	iwg
什	wfhh
洟	igxw
飬	udyes
堗	fpwd
贱	mgt
㩿	tnty
㳙	iceg
䛿	ygkh
䰱	fkkc
㙽	fddj
䵟	lfofu
銨	qpvg
㨾	rugib
榳	sytp
旍	ytwc
徴	tmgt
起	fhn
䒲	avta
伡	wlhh
眳	hqkg
㗖	kevgr
䐖	enoy
掅	rgeg
曶	qrjf
姑	vd
螋	jvh
渼	iugd
㣱	tgmyy
䩾	afyo
蟁	najj
威	dgv
汿	icbhs
豟	eynn
嬯	vfkf
㞝	dhin
啢	kgmy
䨮	fdhv
苯	asg
㐟	djdna
困	ls
缹	rmou
蟽	jfup
鏷	qogyd
䍖	lqnb
聆	bwyci
俌	wgey
竖	jcu
舫	teyn
蟺	jylg
休	ws
嫇	vpju
樁	sdwv
拊	rwf
㵜	iiff
涀	ihqn
痁	uhkd
眯	ho
滹	ihah
塾	ybvf
讛	yafc
䬖	mtjgw
䢠	oapk
牫	trat
沺	ilg
忁	tjbi
罙	pwsuk
愡	nqrn
愙	ptkn
桏	sabh
㮉	swgwd
㤽	ndtf
伢	wah
㑗	wtmt
㭮	svgq
橋	stdko
鈁	qyn
肤	efw
㜡	vtwh
噞	kwgw
䙷	hqfu
惬	nag
芨	aey
㰀	stqi
㳠	idpy
抯	regg
浻	imwk
懯	gehnh
鄵	kkkb
憨	nbtn
䎁	dng
㬿	eybt
呇	ikf
惨	ncd
㞛	ntxj
愫	ngx
畦	lff
畁	mgjj
槟	spr
镁	qugs
慄	nssy
砤	dtbn
泋	ifah
鞈	afwky
沋	idnn
缠	xyj
壶	fpo
奨	uefd
蚐	jqug
曇	jffc
䅔	tvlg
㔣	llll
㷡	hano
肬	ednn
㓃	pyta
爴	laky
蹼	kho
㳭	iksy
踮	khyk
颷	mtjo
郶	ukkc
侒	wpvg
䕐	apyl
冚	pmj
郱	uabh
賻	mgef
䙩	puae
㔜	ebln
朥	eool
瞣	hkkn
㶶	opeyo
倳	wgkh
笄	tgaja
㥢	nusg
祕	pynt
浈	ihm
槔	srd
緐	txgik
葩	arc
迨	ckp
迄	tnp
美	ugdu
䨖	fdef
䀡	hhkg
諏	ybcy
笾	tlp
糌	othj
铠	qmnb
瞡	hfwq
砉	dhdf
釜	wqf
䭮	deuh
峘	mgjg
屗	ntff
秸	tfkgv
㔬	xjj
劫	fcln
後	txt
㷊	ssou
薻	aivs
勽	qwi
梑	sqto
鉣	qfcy
锉	qww
㞴	mqan
䅘	tswwq
誎	ygki
謌	yskk
堿	fdgth
橭	sduh
掤	reeg
錸	qsww
坃	ffqn
蜛	jndg
㠾	qbmh
韧	fnhy
蔲	apft
峏	mdmj
讉	ykhpb
捨	rwfk
泺	iqi
埍	fkeg
㒠	whqg
㿘	uook
錋	qeeg
婄	vukg
㕾	ikxb
彾	twych
椕	swvs
矪	tdte
鋞	qgva
戤	ecla
旼	jyy
肟	efn
踆	khctr
䪄	afaw
㸫	trrhp
䅮	twykh
風	mtjit
㟎	mevg
㦱	gafdc
洀	itey
染	ivs
諁	yccc
䅟	tcde
搹	rgkh
㲘	mtfn
䨍	ffjj
壘	lllfx
㬕	jpyd
㢒	yhagf
翶	rifn
哹	kebg
䘪	puyq
怽	nfiy
獇	qtuc
㧼	rgey
癒	uwgnq
㾭	utoi
㓤	fkjh
㚪	vtfn
筁	tmaf
敀	rty
髯	dem
潈	itle
疲	uhc
擪	djer
逋	gehp
湼	ivag
雬	fsu
蓛	agmt
裍	puls
失	rw
梍	sran
妎	vwjh
䒩	atu
儼	wkkt
侂	wyta
勣	gmln
㐼	wtahs
狟	qtggn
句	qkd
錼	qdfi
氥	rnsf
摢	rhah
刷	nmh
榮	oops
鉜	qwfy
㠢	mrqe
陖	bcwt
槡	sccs
坴	fwff
脊	iwe
㼙	mhgn
抷	rgig
䯰	dewjt
睵	hfak
砛	dwynz
㥹	owvn
䗵	jglg
贴	mhkgz
鐒	qool
悔	ntx
啉	kss
犅	trmm
沷	idcy
㻰	gdhv
䓚	ateg
䭰	tjdh
㑒	wgkwl
寺	ff
屃	nmik
摉	rpwq
㔾	bnnq
谮	yaqj
偯	wyey
㻞	gyna
㪾	tkrh
寿	dtf
鎴	qthn
蚯	jrgg
淀	ipgh
几	mt
隢	bffq
㷢	udao
毒	gxgu
莄	agjq
䉢	tfwkf
㖓	ktdh
㸪	trkh
钯	qcn
偧	wdqq
蕋	ahhh
襗	pulf
啩	kffh
恈	ncrh
㚾	vkqn
醾	sgyo
衋	vfhl
至	gcf
瘁	uyw
耻	bh
謪	yumk
粯	ohqnb
瑓	ggli
鋁	qkkg
镧	qugi
競	ukqq
枹	sqnn
㒐	wtqj
賉	mtlg
癌	ukk
㪍	fpbt
兢	dqd
掝	rakg
蔟	ayt
熞	oahf
讵	yang
㮪	sams
篥	tss
稁	yptu
鍲	qnaj
䣁	nbh
譐	yusf
幖	mhsi
澾	ifup
馣	tjdn
㩖	rglg
僃	waqe
㭬	sey
㶵	wtfo
峝	mmgkh
㣜	tgaj
傍	wup
文	yygy
㝯	ptdk
妃	vnn
聪	bukn
㦴	atkd
满	iagw
捪	rqaj
迼	fkpd
猨	qtec
盳	hynn
㙬	swwfk
疕	uxv
㹲	qtfb
䘄	ftjj
轿	ltd
逬	tftp
衹	puqa
畴	ldt
橶	sfja
煍	otoy
㖧	kqaj
攸	whty
辔	xlx
䙨	puje
戂	nysd
蟈	jlag
掰	rwvro
却	fcb
蟤	jnnw
遵	usgpo
㹠	qtgnb
釫	qfnn
蝿	jjjn
忄	nyhy
襓	pufq
簒	thdc
雭	feyu
䀶	hyve
㓲	ynmj
铂	qrgl
滏	iwq
銶	qfiy
亼	wgf
牎	thgnj
譈	yybt
寍	pnlf
凊	ugeg
䙙	punhy
靉	ffct
樱	smmv
菢	arqn
㟁	mdfh
特	trf
岀	mmj
㑴	wvpc
屣	nthh
弨	xvkgm
㾓	uked
䆓	pwcq
鞱	afev
樔	svjs
䙋	pupg
譤	yryt
竘	uqkg
袮	puti
枌	swvn
媌	valg
㦿	ynsi
馓	qnat
旉	gehy
追	wnnp
戇	ujtn
娓	vntn
㰖	sahq
奔	dfa
逞	kgp
沕	iqrt
侀	wgaj
契	dhv
澳	itm
筪	talj
易	jqr
蠫	eejj
柽	scfg
昐	jwvn
搜	rvh
㡢	mhjnk
乶	gehn
㚉	eqqu
煴	ojlg
睛	hg
跺	khm
岩	mdf
箞	tudbx
㸻	trcd
倝	fjwy
㨇	ihcr
厢	dshw
銃	qycqs
䐑	eans
黾	kjn
勗	jegl
㫐	jxb
䏥	emfg
䨹	fwho
䢳	mbh
䦺	bshh
渤	ifp
罫	lffh
㦸	hjat
蒪	agefb
㔊	ylkj
烼	oey
鬘	dejc
㹣	qttu
鈾	qmg
璜	gamw
怸	synu
㒲	tyjfj
琩	gjjg
浨	ipsy
爇	afwoi
籃	tahl
腙	epfi
䀪	htfhm
飡	uwye
晲	jvqnv
㯮	slqj
魒	rqcib
围	lfnh
㱏	fhf
蒚	agkh
蚽	jgig
幒	mhtn
镮	qlgek
詺	yqkg
䉺	oag
珲	gpl
䑸	tepi
㡍	rdmh
咚	ktuy
晬	jywfo
澘	issj
伦	wwx
辅	lgey
㕤	kvnk
贖	mflm
垵	fpvg
鋼	qmum
室	pgc
齓	hbnn
㞢	bhgd
宊	pdu
䥠	qadt
桥	std
借	waj
点	hko
䔣	atjh
现	gm
宎	ptdu
痞	ugi
儾	wgke
媺	vmgt
㨔	rdgtv
俳	wdjd
䒬	afiu
蕢	akhmf
姼	vqqy
厑	dkxv
黫	lfof
焰	oqv
䎠	vydj
㛤	vgmya
呍	kfcy
檑	sfl
偀	wamd
蘎	afec
㫗	jbf
渁	iiiy
㑌	wagg
㰛	saxs
冮	uag
謏	yvhcp
呩	kfiy
䎶	bjhh
笐	tymb
噾	kpwj
怦	ngu
褂	pufha
愔	nujg
漐	fufir
娦	vrgw
麬	swwca
婍	vdsk
儉	wwgwo
拾	rwgk
蠓	jap
盃	gilf
㼤	dhvn
彡	ett
猝	qtyf
柠	sps
贄	fufm
纠	xnh
槑	ksks
炻	odg
蚷	jang
曌	jepa
㱞	gqug
荏	awtfy
蟬	jkkfk
賍	myfg
費	xjmu
痱	udjd
㹄	trlt
硧	dceh
廭	ytgm
痏	udedf
㸤	uthu
犢	trfmb
暁	jfaq
扆	ynye
滗	itt
揢	rptk
袊	puwct
粎	onyy
蓞	aevf
咂	kam
㑖	wwkho
諨	ygkl
擡	rfkf
焞	oybg
㱴	gqgm
犺	qtymz
㲔	utfnc
敒	wjht
䛁	ymfg
郓	plb
齛	hbann
捬	rywf
唒	ksggk
挨	rct
囹	lwy
獰	qtps
侳	wwwf
䍼	udaj
䣲	sgca
䍭	udxu
䬘	mtjkt
搡	rccs
鐰	qkks
㕵	kggw
珸	ggkg
曖	jept
㴌	ivdg
蒨	awge
啔	ynak
遲	nirp
㕮	kwqy
訝	yahto
奻	vvg
乛	nnllw
给	xw
軄	tmdj
禋	pysf
蹀	khas
䇦	tmdud
们	wu
䆦	pwoo
㿉	ukhmg
校	suq
䇇	unan
咏	kynj
嶟	musf
掃	rvph
獤	qtyth
譒	ytolf
熱	fwfon
搕	rfcl
䞻	fhcl
岢	msk
丸	vyi
㗪	khxi
柋	wasu
艃	tejf
峌	mgcf
迮	thfp
柟	smfgl
妾	uvf
䒷	atdf
䶙	hban
孫	bif
㟙	majg
䩬	afdh
寥	pnw
誻	yijg
毵	cden
詰	yfkg
狛	qtrg
姮	vgjg
鉝	qug
镽	ddui
暎	jamdb
撬	rtfny
澂	imgtk
睳	hdff
滝	iujn
㡛	mhaq
峢	mgqj
浛	iwyk
貱	mhcy
轸	lwe
峛	mgqjr
惄	hicn
梩	sjfg
猽	qtpu
蟟	jdui
殥	gqpw
砞	dgsy
㐌	tbbx
岼	mguh
懑	iagn
瑣	gimy
殟	gqjl
运	fcp
薰	atgo
筂	tibby
苛	as
囜	lci
謫	yumd
漻	inwe
睤	hlgj
㬁	jiwk
谕	ywgjy
錗	qtvg
㠄	mnrf
䙺	ohqn
茙	aadr
荱	antn
盟	jel
谟	yaj
屋	ngc
优	wdn
䉹	tfkw
戺	ynnn
塸	fakk
淼	iiiu
袢	puux
銋	qwtf
欞	sfkw
䛛	ylkgn
宻	pcum
趴	khw
烬	ony
㷩	taho
㶔	illd
鈪	qdbn
禝	pylt
铆	qqt
茻	btbhs
䰑	defjv
礔	dnku
㣴	tamwz
郘	kkbh
咑	krsh
衫	pue
謬	ynwe
䬊	mtjwk
瘃	uey
焒	okkg
仒	wuu
璥	gaqt
过	fp
䚲	yet
蛚	jgqjw
䒫	awau
㺽	ggig
恚	ffnu
脡	etfp
祖	pye
铚	qgcf
蹎	khfw
浟	iwht
搢	rgoj
痷	udjng
瘨	ufhwz
砳	ddgc
柗	swkg
贿	mde
狹	qtdwp
㵕	iccn
晝	vfjg
杲	jsu
噑	krif
甙	aafd
坮	fckg
䑍	emmv
沶	ifiyc
兄	kqb
谰	yug
㻕	gnbm
何	wsk
棢	smun
锿	qyey
䜐	bday
仉	wmn
㥾	naak
㪥	haecb
腐	ywfw
恬	ntd
㫲	jfpb
㯓	swgn
孍	vkkt
䰆	decs
摍	rpwj
抔	rgiy
䬍	mtjna
癘	uajy
檹	sytk
嶾	mean
䤒	sgxt
瀃	imjr
黭	lfoap
葢	adyl
摎	rnwe
蟯	jffqi
梹	srgw
㮖	safh
礫	dxrs
㱘	djeh
漖	iftt
涢	ikmy
钐	qet
鉶	qgajv
涌	ice
屓	nmi
袻	pudjr
諯	ymdj
会	wf
凮	mdjd
狕	qtxl
鐃	qffq
颳	mtjd
哭	kkdu
鎺	qpyg
蜟	jyce
杧	synn
蔰	aync
爺	wqbb
潔	idhi
褉	puddu
詐	ythfz
襨	puof
﨤	eyyp
蜂	jtd
㴎	idfi
俖	wgik
愶	nlle
犄	trd
䟵	khfy
简	tuj
䘜	pumh
窀	pwgn
廛	yjfk
獖	qtfm
㩕	rfwc
柆	sug
睈	hkgg
䙤	pump
䢚	gjqp
偮	wkbg
峜	mwhf
阾	bwycq
蝱	ynjjo
㸙	wqfj
齒	hbj
䒹	adiu
䩳	afpc
䉞	tdgn
趷	khtn
嬣	vpns
舀	evf
㛋	vwny
醆	sgaa
鏑	qumd
瘧	uhag
燼	ovhl
貒	eemj
㡤	mhow
枩	swcu
㨁	rfhg
琒	gtdh
碳	dmd
䎾	bwgac
樥	sath
懊	ntm
謯	yhagn
痕	uve
侈	wqq
崫	mnbmy
瀼	iykef
䠎	khnfn
聎	biqn
腽	ejl
捒	rgki
塒	fjffg
镀	qya
婱	xyxvl
逿	jgqp
贲	fam
䚄	vihq
釧	qkh
䂊	cbte
㯙	syct
䜜	yhph
玡	gaht
㴽	iton
馞	tjfb
藫	aisj
㢖	ytold
恫	nmg
䝫	mthfm
㥗	njyy
强	xk
㦥	npdn
葈	acks
昨	jt
洿	idfn
搼	rudr
抦	rgmw
济	iyj
孚	ebf
諵	yfmf
㦪	noyc
對	ogufz
㚫	veyy
欂	saif
㷐	ovfg
铇	qqnnn
滍	ibhj
贔	mmmu
础	dbm
諑	yeyyy
箥	tihc
媱	verm
寰	plg
䣛	swibs
誹	ydjd
䁳	hada
㒂	wafj
笜	tbmj
甁	tftn
馝	tjnt
籥	twga
搧	rynn
嵓	mkkk
靣	dlkf
蹒	khawo
曲	ma
棭	sywy
㷖	jovk
㭁	sen
䎃	mfng
䯽	deuk
勺	qyir
夙	mgq
馥	tjtt
馛	tjdc
鈖	qwvn
瘳	unwe
缽	rmsg
晾	jyiy
鑒	ahnqx
靵	afnf
脍	ewf
躈	khrt
彞	voxa
洷	igcf
墨	lfofz
杚	stnn
䒇	tepl
呡	knan
歯	hobj
悦	nukk
䛅	ylh
剶	xejh
䍸	udgf
蕒	almu
殏	gqfy
岧	mvkf
浪	iyv
踳	khdj
刮	tdjhk
畩	lyey
茘	avvv
娊	vhqn
㘞	llv
掲	rjqx
蛂	jdcy
誏	yyvey
蝥	cbtj
訮	ygah
耘	difc
燲	ollm
黰	lfowr
贳	anm
噫	kujn
恕	vkn
埖	fawx
亠	yygr
翈	lng
巙	muht
芔	bhbh
洫	itlg
已	nnnn
㢎	ytfv
殛	gqb
嚍	kvhl
玫	gt
肰	edyw
䐔	eyna
缙	xgoj
娞	vevgs
俋	wkcn
釓	qnnd
吻	kqr
粠	oawy
覭	pjuq
祇	pyqa
误	ykg
酱	uqsg
䦂	qynn
㡀	umii
崒	mywfh
皍	rxbj
岫	mmg
烓	offg
㛦	vssy
談	yooy
㤣	uanu
糣	oaqj
夶	ddy
泆	irwyi
膈	egk
弹	xuj
趆	fhqyd
傟	wwcnm
汄	iwy
喭	kute
䋢	rrxi
楛	sadg
覄	swdu
䍿	ngf
䩁	djdnp
鉓	qtmh
㓰	gmbj
裘	fiye
䛴	ydskt
虎	ha
㫅	ywfj
爍	oxrs
霈	fig
缢	xuw
㮯	sley
錮	qldg
釻	qvyyr
㢋	ywqq
轺	lvk
众	www
奈	dfi
䅊	tyta
咒	kkm
朶	esu
郋	thbh
醟	oopg
㘸	gqxf
㳞	iwkh
踟	khtk
郐	wfcbp
碍	djg
䚴	yeg
岉	mqrt
㒏	wpfuw
䠌	khiec
㧻	reyyv
玮	gfn
錎	qqvg
䇽	trrj
鬤	deye
菩	auk
吏	gkq
㸉	ouoo
䪬	ujfbp
媤	vlny
䝷	tdkm
䣠	fwfbf
針	qfhj
孛	fpbf
佗	wpx
靋	fidh
䒚	aitr
鉦	qghg
䠲	tmdc
䍥	ldth
适	tdp
䁋	hans
藆	apfr
汅	ignn
檶	sdak
剂	yjjha
檬	sap
攝	rbbb
䥇	qynnk
灺	obn
祻	pyldy
荁	agjg
莠	ate
舐	tdqa
冷	uwyc
樽	susf
玣	gyhy
䖍	hati
姩	vrhf
䶫	hbkt
襂	puce
袟	purw
睶	hdwj
齖	hbat
灶	of
仩	whg
屶	mvb
㚳	vlkg
鎘	qgkhl
芩	awyn
愛	epnt
蟄	fufj
㥄	nfwt
䗍	xeju
㗙	kqbt
焖	oun
迾	gqjp
銘	qqkg
奾	vmh
瀝	idth
㠚	mogf
䕍	ayek
㥺	nfcl
氿	ivn
笎	tfqb
誡	yaahx
袋	waye
玟	gyy
磗	dgef
嵋	mnh
咄	kbm
嗟	kuda
㜮	vahl
䞴	fhmk
䙎	pued
瘥	uuda
䤺	qdrh
阱	bfj
銈	qffg
糑	oxuu
滸	iytfr
鑸	qllf
厚	djb
纫	xvy
服	eb
栋	sai
䚆	amdq
飇	mtjdc
焙	ouk
䍻	udnw
䬅	mtjlv
蜩	jmfkr
虊	axys
㘥	leri
䏄	bpwf
傏	wyvke
鉇	qtbno
逫	cccp
蚉	yju
榽	sexd
瞇	hopy
租	tegh
抁	rcqn
杭	sym
諸	yftj
箃	tbcu
䍛	lldf
䑃	eape
蔧	adhv
旆	ytg
渷	iukq
㝇	ybyb
礛	dahl
㮍	uejs
玷	ghkg
字	pb
䄶	txjhe
绀	xaf
琞	jegy
禎	pyhm
爐	ohal
唫	kqg
靭	afvyp
㤁	gdnu
钺	qant
炿	otmy
爧	ofkw
锘	qad
辩	uyu
䘈	jdal
玎	gsh
咛	kps
娭	vctd
蝓	jwgj
辬	uyuhq
㓳	jghj
释	toc
餋	udwe
巡	vp
噗	kog
钊	qjhd
鋨	qtrtz
睼	hjgh
浅	igt
讖	ywwg
䗼	jtgo
欉	sogc
螑	jthd
潼	iujf
篓	tov
甼	lsj
䟍	fhty
皢	rffq
焺	ojta
属	ntk
瑻	gxfm
㘡	llk
湘	ishg
狢	qttk
垭	fgo
残	gqgz
焸	jjou
㸣	thgw
姌	vmfgy
炥	oxjh
㯢	snnw
尬	dnw
獝	qtck
嫀	vdwt
䃝	dftt
牧	trt
叺	ktyy
鼌	jgkn
柼	spwyd
沀	icbh
潒	iqje
蘦	afkkk
㿏	uvtd
榁	spgf
钇	qnn
垈	waff
蒫	auda
镠	qnwe
粒	oug
䑧	tewf
蹻	khtkv
蓎	ayvk
䂰	dtjh
䓓	adtf
蚌	jdh
痂	ulkd
䟲	khyq
氋	apfn
玾	glh
㶴	oqqy
磲	dias
唻	ksww
崜	mtgf
璐	gkhk
猁	qtt
箌	tgcj
蛒	jtkg
喷	kfa
㾡	ufcb
䌸	xfnyo
襀	pugml
卩	bnhn
斾	ytmh
䕂	ackp
酔	sgvf
澣	ifjf
蓪	acep
蘲	allf
㤟	manu
仞	wvy
湀	iwgd
毰	tfnko
眫	hufh
䀺	whthg
㽙	lcqn
㾪	uith
乳	ebn
殄	gqwed
叿	kag
㼞	guhn
㥥	njmy
憍	ntdk
㡖	mhtf
䑥	teey
圇	lwga
蚖	jfqn
簿	tig
卽	rxbh
唗	kfhy
賯	mqjb
懨	ndjdw
抬	rck
這	ypd
勵	dajl
䓨	aprm
齰	hbaj
㫹	jrnr
㝶	lqfu
懔	nyl
刑	gajh
镹	dqyy
韭	djdg
铽	qany
赟	ygam
贬	mtp
拳	udr
棉	srm
莾	adfa
绠	xgj
㽗	lwyr
㝗	pyve
查	sj
恲	nuah
瓝	rcyyb
脬	eeb
泸	ihn
踠	khpb
買	lmu
醤	uefg
痾	ubsk
媮	vwgjl
帾	mhfj
嘜	kswt
䘇	yjjj
弁	caja
蕼	advh
㖌	wvkxm
徑	tgva
貼	mhkg
佲	wqkg
㟉	mprh
㘂	kuxn
煺	ove
兘	fqck
袑	puvkv
枷	slk
际	bf
呗	kmy
咤	kpta
歬	hteu
䑱	tepb
库	ylky
鎹	qudp
㥂	njgf
珕	gllls
沿	imk
躶	tmds
䂲	fcld
殭	gqgg
捋	refy
秾	tpey
啴	kujf
譊	yffq
霷	fjjr
靔	gern
鏂	qakk
岓	mrh
覧	ahnqy
簄	tync
崕	mdffi
朜	eybg
淶	isww
洨	iuqy
聧	bwgd
稹	tfhws
䄥	pyfwk
㛬	vfwf
蚜	jah
付	wfy
凯	mnm
鎳	qths
谡	ylw
忝	gdn
镙	qlx
郫	rtfb
亖	fff
摔	ryx
戎	ade
䂽	dhjh
裴	djde
㶆	iyfj
邒	sbh
哷	kefy
咀	keg
萐	agvh
扝	rfnn
㬽	ekkn
癳	ulli
誨	ytxu
簮	tfwj
牼	trga
痄	uthf
燂	osjhs
㚱	vrgg
狘	qtatt
婲	vawx
㠗	mtmd
婮	vndg
苢	anhn
䘎	jxyx
漠	iaj
䂿	dijgm
幫	fffh
笹	tanb
湯	ijgr
甘	afd
壨	lllf
卆	vfjl
㸛	nhdkk
讪	ymh
埣	fywf
薇	atm
澚	itmn
蛆	jegg
罸	lyfu
㽡	lrtf
锡	qjq
鍝	qjmy
䶨	hbww
塲	ftjr
桍	sdfn
颬	mtjt
㺺	ghg
湢	igkl
燣	oylt
䵗	twil
袹	pudjx
粧	oyfg
䞡	fhjg
怛	njg
盩	fufl
䂭	duqy
沉	ipm
酺	sggyv
澸	idgn
䊎	oudb
莹	apgy
盶	hfqn
䉯	tahm
㿷	udac
啙	hxkk
㔧	hallr
肧	egiy
技	rfc
溍	igoj
箜	tpw
䄬	tbnz
珙	gaw
濘	ipns
㧅	rvnj
祾	pyft
剻	meej
涹	itvg
峈	mtkg
得	tj
冠	pfqf
醯	sgyl
銛	qtdgq
䰓	dety
飧	qwyez
牨	trym
㪞	jhhct
譬	nkuy
彉	xamwe
㳏	ikqy
舼	teaw
忉	nvn
髝	ymkl
熈	tahow
洺	iqkgh
溨	ifas
夫	fw
檊	sfjf
楳	safs
龵	龵
遑	rgp
稑	tfwf
䛺	ylwj
犉	tryb
辫	uxu
掓	rhic
䠐	khhd
瀵	iol
嵾	mcces
㣑	yvee
槵	skkn
弧	xrc
葶	ayp
痀	uqkd
㞗	nfiyd
㖂	kjnt
䆐	dwtt
簈	tntf
鑕	qrrm
罨	ldjn
迭	rwp
厔	dgcf
戯	haoa
勼	qvv
蹵	yidh
䶥	hbhg
丘	rgd
棃	tqts
鞜	afij
攣	xyxr
筕	ttfhe
蒇	admta
黒	jfou
烴	ogva
昘	jyb
饦	qnta
䁙	hjpv
獄	qtyd
䵭	lfoj
悫	fpmnw
药	ax
鐻	qhae
幚	dtbh
筺	tagy
谝	yyna
増	fulj
㟏	mwykt
掠	ryiy
兰	uff
㫨	jpvg
䠜	khab
葻	amtj
位	wugr
䌹	xmkg
罏	rmhl
歱	htgf
訔	myf
澟	iylt
膘	esf
脙	efiyf
時	jffy
㲍	fctn
䎻	bmfkv
轰	lcc
䂇	cbtfm
屉	nan
翝	pdcn
㗳	ktwk
葲	ariu
幬	mhff
蕊	ann
喛	kefc
近	rp
稲	tehjk
慁	lenu
嫨	vakw
翚	nplje
磹	dsjh
鈰	qymhc
榭	stm
䀀	iblf
㝷	vavf
昊	jgd
賭	mftj
蝧	jamd
㬔	jnwe
謗	yupy
釗	qjh
砎	dwjh
汌	ikhl
闷	uni
囻	lnav
䰡	rqcwe
㠓	mape
庒	yfyi
莆	age
䐥	ewcnf
单	ujfj
葑	afffk
佉	wfcym
镜	quj
揼	rdiy
桂	sff
籡	trww
睨	hvq
皵	ajhc
棬	sudb
筃	tldu
靽	afuf
錇	qukgs
今	wynb
釵	qcyy
內	mtyi
䶟	hbqv
葕	atih
杏	skf
媩	vdeg
廼	spd
嵍	cbtm
䕗	athj
㢔	ytwh
朂	jblb
杣	smh
嬋	vkkf
兝	dqwv
含	wynk
䑙	tdmfq
珫	gycq
漏	infy
遯	eepi
憭	ndui
凉	uyiy
傚	wuqt
砑	dah
浓	ipe
謳	yakk
厛	dkrk
㜒	vvah
胿	effg
塍	eudf
唝	kamy
怲	ngmw
䙜	putpr
劜	lnnj
䖔	fchm
篲	tdhv
㫙	jfwy
蠤	usgj
䫽	mtjnf
訴	yryy
油	img
粞	osg
䦀	qng
屯	gb
䏎	emyy
薹	afkf
鈊	qny
灠	iahq
蟍	jtjs
凟	uflm
孥	vcbfm
凇	usw
轳	lhnt
珡	ggwu
闳	udc
鑰	qwgaj
喌	kkyh
浑	ipl
峨	mtr
䔹	abue
慢	nj
藷	ayfj
㗲	kvfg
䞚	fhfc
脜	edhg
謺	fufyl
甛	aftd
舎	wfkf
迌	epd
葖	apwd
䌿	xgklv
索	fpx
想	shn
舯	tekl
仐	wfj
㱸	gqnu
虺	gqji
㤜	ndyt
㮺	sgkkd
棏	sjgf
畘	lmfg
蛤	jw
䤳	qywy
腜	eafs
匜	abv
㓇	utdy
䕕	aijc
戾	ynd
陆	bfm
间	uj
炗	aou
秱	tmgk
㥚	nvwy
耧	dio
忔	ntnn
障	buj
鏫	qtjs
䚳	yfcyt
乤	ghnb
㛗	vwwf
㡹	yegd
鼿	thlq
捕	rge
徧	tynaq
漦	fiti
豜	egah
岱	wamj
湆	iujgk
捖	rpfq
㮟	sdsy
鍉	qjgh
幹	fjwf
㘹	hxff
髫	devk
嵈	mefc
倵	wgahe
衑	twyh
䄲	tmwy
㺐	qtvs
像	wqj
䁎	hyps
㗼	kogw
検	swgwk
䘒	tlct
䃱	dfag
妀	nvg
缧	xlxi
䏁	bpuh
㼳	ithnm
䚷	ywgn
䕭	afwow
䊀	odge
妭	vdcy
捰	rjsy
釔	qnns
㻃	magy
楐	slwj
搏	rgef
鋚	whtq
䔻	aybt
朘	ecwtf
䗃	jaat
嵇	tdnmv
㽀	usgn
钳	qaf
䣍	djnb
侫	wynv
醜	sgrc
差	uda
簠	tgel
畞	flqy
碮	djgh
暧	jep
研	dga
埃	fct
铔	qgog
齹	udab
瘔	uadd
㢺	xuvg
䢶	sbhd
茏	adx
礢	dude
篘	tqbts
㮲	sqbtx
䛕	yjqy
掻	rcjy
愠	njlg
㸀	oymf
菨	auvf
瘟	ujl
踏	khij
钘	qgahx
绾	xpn
琫	gdwh
剭	ngcj
蔊	aojf
䘕	tymh
䐾	elff
蕺	akbt
齱	hbbc
孑	bnhg
㲼	iqyw
脂	ex
搻	wgkrl
爆	oja
怙	ndg
㼲	dmjns
㱤	gqsr
䕦	ayny
忀	tyked
爜	oogc
玢	gwv
㙷	fjxo
踦	khdk
掺	rcd
䦁	qdtb
䃦	ybtd
亮	ypm
窳	pwry
暺	jkkf
楠	sfm
㫛	jkqn
蒀	ajlf
臄	ehae
狞	qtp
酕	sgtn
㡋	mhdn
住	wygg
䑗	vjgr
䏆	bgmj
膻	eyl
盼	hwv
䏦	etdg
绢	xke
坏	fgi
薤	agqg
怩	nnx
蓆	ayah
茷	awar
笉	tquf
諃	yssys
铧	qwx
靈	fkkw
梷	hkcs
锰	qbl
犘	yssh
孤	br
揌	rlny
膩	eafm
蚧	jwj
賲	wksm
恓	nsg
蚴	jxl
䐏	edwj
㖶	ksfg
㿂	umgt
例	wgq
釞	qtyy
犲	qtft
㽩	lcce
戚	dhi
銓	qwgg
螾	jpgw
樇	swhe
峖	mpvg
斫	drh
鄣	ujb
咍	kckg
儤	wjai
啾	kto
沣	idh
勜	wcnl
痿	utv
㺀	qtqnw
巕	muwv
詅	ywycb
謚	yuwl
嶪	mogww
簽	twgw
晵	yntj
䩒	afgf
奛	djef
捀	rtdh
㠽	mhtu
憤	nfam
凋	umf
鈵	qgmw
⺁	⺁
	
	
	
⺄	⺄
⺈	⺈
⺋	⺋
	
⺗	⺗
	
	
	
⺧	⺧
	
⺪	⺪
鍀	qjgf
蘮	aldj
艖	teua
樎	spwj
眺	hiq
䠵	tmdfz
炵	otuy
罭	lakgu
昵	jnx
倸	wesy
嘰	kxxt
裲	pugyu
㠙	mype
稵	tuxxc
䠓	khugz
㾜	udww
涜	ifpq
淩	ifwt
乫	lknb
禳	pyye
㢷	xmqy
㘁	klff
娅	vgo
䆨	pwjd
块	fnw
鞛	afuk
岽	mai
丞	big
檧	saqn
叧	kvb
鑗	qtqig
䵮	lfori
浭	igjq
嗦	kfpi
螼	jakg
俵	wgeyl
毠	lktn
䤵	qdjd
找	ra
錶	qgey
庥	yws
辎	lvl
揔	rqrn
鋝	qefyw
聭	brqc
蘐	ayec
笝	tlcu
庣	yiqv
周	mfk
牪	trrh
㴆	ivph
秃	tmb
篞	tijfr
蝣	jytbu
伵	wlg
摂	rbiy
湠	imdoc
㸧	ahte
扽	rgbn
倌	wpn
棜	sywu
晸	jght
炑	osy
㴦	ipkk
薭	atrf
䔬	alawo
迠	hkpd
訲	ykhh
䋜	ynci
鄹	bctb
䪃	afyt
怴	nant
谲	ycbk
睮	hwgj
惿	njgh
樸	sogy
烀	otu
艮	vei
螓	jdwt
饴	qnc
䉡	tylgd
岦	muf
怅	nta
砢	dskg
媕	vwgag
荒	aynq
險	bwgwx
拖	rtb
䨺	ffcc
祍	pytf
秩	trw
蛊	jlfv
逳	ycep
䇠	tygf
铉	qyx
台	ck
癭	ummv
忨	nfqn
㔩	qfcls
灹	otan
菺	ayne
冃	mfdp
圾	fe
䐇	eqrj
䁧	hakw
禁	ssf
濆	ifam
孜	bty
䄁	pyan
䢤	tsyp
蕗	akhk
问	ukd
代	wa
侥	watq
钶	qsk
箿	tkbf
嶭	mwnu
螒	fjwj
䎵	bntt
桳	scdf
䁌	hleg
扤	rgqn
噢	ktmd
嬘	vuep
灗	ijyg
䅨	ttjg
姞	vfkg
䘽	purq
扉	yndd
㕕	ccus
茞	aahh
淹	idj
䊧	oxjm
届	nm
竼	tmyu
蕿	aoec
䦊	dhiy
椬	speg
詆	yqayn
檮	sfnf
值	wfhg
黷	lfom
䜇	yuce
杯	sgi
螽	tujj
弊	umia
溹	ifpi
劒	wgkyt
噣	klqj
钑	qeyy
訢	yrhz
槖	fpds
潀	ilwu
湄	inh
怌	ngig
莴	akm
㵃	ijpx
窡	pwcc
苰	axcu
䌶	xfttw
蜪	jqrm
执	rvy
慕	ajdn
舣	teyq
鋈	itdq
㦭	nfkw
過	mk
桓	sgjg
㠮	uoga
受	epc
餮	gqweu
㾼	uvep
鞖	afevm
挲	iitr
㰃	srmi
䕬	axgg
俯	wyw
逼	gklp
瘷	ugkt
鐜	ybtq
㮭	sclf
熆	ofcl
䓩	asfc
莔	alwm
讞	yhad
䯾	demk
苗	alf
釷	qfg
埊	miff
㔕	rnln
苫	ahk
姂	vtpy
履	ntt
寇	pfqcr
㿻	flf
塨	fawnv
媡	vgli
㭘	swgk
畻	ludf
岋	meyy
㴖	iafh
㠆	mkkf
䟓	khsh
蓥	apqf
擴	ryaw
齯	hbvq
皳	fiyc
跂	khfc
㬸	eawx
逩	dfap
憝	ybtn
畋	lty
总	ukn
镘	qjl
瘙	ucyi
酬	sgyh
菥	asr
窣	pwyf
㝴	fqfi
尃	gehf
㥡	nnxs
㐊	fnbe
䢑	qayp
飋	mtjtn
旨	xj
丿	ttl
䶔	hbbn
尋	vakf
艕	teuy
㙇	feyy
孽	awnb
杄	stfhn
㪜	mdmc
宍	puu
筛	tjghk
䣽	tdkg
暲	jujh
煸	oyna
㓊	umgkp
貙	eeak
螟	jpj
㘯	ftln
偛	wtfv
钼	qhg
湧	icel
溃	ikh
䤃	sguj
㡳	yqav
堌	fldg
跲	khwkh
郾	ajv
枡	stahj
䑣	teet
铄	qqic
㘫	ffjh
䀻	hmgn
跄	khwbi
友	dc
怐	nqkg
潘	itol
僤	wkkf
蕛	atut
吾	gkf
㶎	ilgp
俟	wct
浰	itjh
溌	iwfq
熮	onwe
尓	tiu
讀	yflm
㿁	urdf
㔗	xjln
肇	ynth
羽	nny
暵	jakw
簶	tpyi
䟣	khsy
劬	qkl
猪	qtfjl
䬌	hamj
蹯	khtl
摫	rfwq
晘	jjfh
冥	pju
铞	qkmh
姘	vua
䤕	sgxs
谎	yay
蔷	afu
鈿	qlg
軂	tmdl
缉	xkb
䎓	nijg
路	kht
挤	ryj
㒓	wfup
䪪	lkuj
譩	yujn
膱	euaj
䂟	lkdf
唕	krfh
惽	nnaj
䓧	abkg
幜	mhji
叭	kwy
沪	iyn
㕫	kyn
侻	wukq
䶭	dxgdt
圤	fhy
㸵	trfk
缝	xtdp
圕	lvfj
䀯	hgey
蚀	qnj
佨	wqnn
䝟	eedd
半	uf
笤	tvk
䁉	ynah
㺒	qtne
莲	alp
䣵	sgbg
蕰	aijlq
嫬	vyao
嫤	vakg
戍	dynt
廖	ynw
虼	jtn
颭	mtjky
䁃	hgeyb
归	jv
䵧	falo
耽	bpq
淠	ilgj
材	sft
痫	uus
缚	xge
陀	bpx
簥	ttdkx
滲	icce
膙	exkj
䈼	tpnm
䐂	eviy
㒝	walt
觃	mqbd
劼	fkln
瀅	iooy
猄	qtyi
㮂	hwsu
勇	cel
喀	kpt
滈	iymk
树	scf
下	gh
㞖	ngmi
昩	jgsy
暠	jymk
蝾	japs
鏃	qytdn
剈	kejh
厲	dajy
暋	natj
请	yge
幗	mhlg
柍	smdy
敕	gkit
蝴	jde
矩	tda
氼	iwu
䑊	ekhp
㗞	kdhc
㭩	sefy
醇	sgyb
㤂	eynu
媪	vjl
埈	fcwt
溚	iawkk
獸	kkld
剿	vjsj
疵	uhx
衺	yahe
収	nhcyw
糅	ocb
钷	qak
幍	mhev
螏	jutd
怹	wbnu
噭	kryt
贡	am
㛨	vudn
莛	atfpl
掷	rudbs
岣	mqk
镺	dtdys
鄲	kkjb
苩	arf
篑	tkhm
㩵	rhad
努	vcl
羓	udcn
耦	dij
凥	nmv
奱	xyxd
䛙	ywsy
疗	ubk
檉	sbkg
簨	tnnw
胙	eth
悖	nfpb
膑	epr
㧕	rqtb
㴘	ijhg
䈏	tgkl
堬	fwgj
㲾	piu
蜜	pntj
永	ynip
懩	nude
潨	itli
蕘	affq
腁	etffs
惵	nanst
梛	svfb
沫	igs
䶦	hbgm
机	sm
覮	oopqm
殞	gqkmo
畮	ltxui
䀍	ujtl
䚈	sfhq
逦	gmypq
砐	deyy
㷶	wato
潎	iumt
裇	putlw
貴	khgmw
㶿	ofpb
㜤	vsjh
匕	xtn
筍	tqjf
㘼	fftn
萔	arvk
殎	gqdw
䓪	ajqr
㨠	rpju
錫	qjqr
㮀	sbib
垗	fiqn
㩡	rddd
㼟	rgnnt
懚	nean
盇	dylf
眰	hgcf
膵	eayf
巰	gvaq
䠷	tmdqj
䞫	fhvk
囔	kgke
澏	ikkm
禣	pygfp
㻹	degy
犁	tjr
溕	ipge
㔝	gmhl
噖	kggn
埦	fpqb
幧	mhks
嬫	voos
橔	sybt
晈	juqy
栆	gkhu
茂	adn
㑸	wdsk
䰊	degf
睙	hynd
帘	pwm
㠒	msfj
噴	kfam
囸	lghd
嬻	vflm
乿	exin
搐	ryxl
疧	uqav
禢	pyjn
薐	atft
戗	wba
糝	occe
眕	hwet
潮	ifj
皧	rept
䰟	fcrc
邁	ajmp
安	pv
䘛	pumn
錰	qsoyo
腺	eri
杝	sbn
蝠	jgkl
䝾	gahmy
㚔	dufj
䘝	puayq
赇	mfi
㹸	qtrq
啋	kesy
奅	dqtb
汖	miu
瓭	pqgn
逃	iqp
臐	etgo
恸	nfclk
訇	qyd
崽	mln
砊	dymn
填	ffh
蕜	adjnj
墴	famwc
䥅	fggq
䒀	tetf
盋	dclf
穨	tmkm
鈺	qgyy
鈹	qhcyg
菧	ayqy
精	oge
蟮	judk
癏	ulge
猐	qtun
蒄	apffm
犓	trqt
穽	pwfj
皊	rwycs
㢬	xdcyi
皎	ruq
榊	spyh
汏	idye
长	ta
渽	ifak
檁	sylt
泑	ixln
䠿	tmdma
嘀	kum
麽	yssc
宷	ptou
灟	inij
铎	qcf
嘿	klf
䎏	wynnu
朼	sxn
孾	bmmv
硽	ddjn
殩	gqho
㟐	mayn
䓿	aclf
荟	awfc
嘵	kffq
㘙	kkkt
饱	qnqn
蹩	umihx
㑘	waah
瘱	udwn
㯭	shal
篣	tupyj
啚	kflk
䯭	decu
耂	fte
䏿	ynte
姡	vtdg
㥒	nesy
煮	ftjok
䢞	sspi
㨜	rhay
拌	rufhl
䀩	htkg
㙼	flllg
釅	sgkt
嚦	kdth
㛑	hqcv
敵	umdt
侣	wkk
孕	ebfw
嗢	kjlg
適	umdp
䢪	tdkp
䗆	jpnn
棁	sukq
䘻	puyeb
崾	msv
檄	sry
苀	aymb
岏	mfqny
硦	dgah
厉	ddn
蔗	aya
㹂	ahnhx
苇	afn
檗	nkus
战	hka
屸	mag
桻	stdh
耙	dic
枿	sfah
愁	tonu
蜱	jrt
熠	onrg
狓	qthcj
㨖	rgct
誱	ygvh
柚	smg
镑	qup
媊	vuej
衸	puwj
渰	iwgax
㶇	isaw
躉	ajmh
咁	kafg
㦋	ndfj
爢	yssok
薟	awgwh
丨	hhl
宼	pfqv
橰	sthf
忑	ghnu
暌	jwgd
醄	sgqm
芫	afqb
关	ud
本	sg
䔀	awtv
摾	rxkj
耔	dib
䋀	ynxi
甜	tdaf
錟	qooy
恨	nv
珚	gldy
翿	fnanr
晓	jat
蟆	jajdr
甇	oopnc
翗	qqng
镦	qyb
䆗	pwkh
淜	ieeg
俀	wevg
礪	dday
㺱	wegy
宿	pwdj
俴	waat
胄	mef
䙁	puaam
箣	tgmj
㢚	yhal
滚	iuc
㪒	vqhc
盺	hrh
豘	egbn
㞞	ntwh
蛈	jrwys
粕	org
鞫	afqyz
姁	vqkgu
㓪	yvcv
鄺	yamb
笣	tqnb
衪	pubn
瓣	ur
㜿	bcbhe
根	sve
票	sfiu
遖	fmup
䗿	jpns
巧	agnnl
菽	ahi
溦	imgt
陡	bfh
簔	tyge
㹡	qtyx
弿	pfjx
屬	nilj
㒈	wnbt
碎	dyw
簓	tmfe
乏	tpi
瑄	gpgg
嗒	kawkh
朾	ssh
槥	sdhv
兣	dqdf
羢	udad
寻	vf
枔	swynu
膳	eudk
嗉	kgxi
琏	glp
缒	xwnp
诒	yck
㢆	yjfd
媂	vuph
哊	kdeg
㑛	wgkin
犙	trce
燷	oyli
䂴	dyg
礹	dkkt
獀	qtvc
鈎	qqcy
倦	wud
夎	wwft
䎌	nkhy
毧	tfndb
䋷	cbti
弙	xgfhh
细	xl
攅	rfwm
嚅	kfd
胚	egi
㩙	rpff
直	fh
唄	kmys
䑦	teqk
椆	smfk
㦰	wwae
监	jtyl
脅	llle
鉿	qwgkz
烪	oudy
㐉	snb
奩	dakk
烄	ouqy
弉	nhdax
堶	fdae
歫	hangf
妓	vfc
仲	wkhh
䝚	eenx
硰	iitd
鑮	qaif
髵	dedj
挜	rgog
堮	fkkn
柃	swycc
芹	arj
槻	sfwq
罟	ldf
㞘	neyi
奄	djn
邱	rgb
㒵	rwu
䘊	jtlt
䊕	ovfp
掵	rwgb
瀋	iptl
皟	rgmy
䒥	agmh
疘	uad
廵	vpv
壃	fglg
鬾	rqcc
滓	ipu
均	fqu
鉪	qann
變	xyxt
㮑	stfv
㾉	uwycg
靷	afxh
嫈	oopv
甴	jhk
矃	hpns
茵	ald
姶	vwgk
阺	bqay
豖	eyi
佖	wntt
纟	xxx
诏	yvk
窢	pwag
郺	qqvc
㓗	udhi
綤	vkbi
傧	wpr
杻	snfg
㒌	woom
㯚	stwk
汭	imwys
萺	ajhf
㛛	vtmt
恩	ldn
母	xgu
虤	hamm
㐚	gknb
庵	ydjns
㳩	iamyo
案	pvs
捾	rpnn
㹬	qtgqh
涁	iset
毻	daen
瘺	unfi
䄪	tqyy
塩	ftkl
雯	fyu
竆	pwtk
賝	mpws
蟉	jnwem
鄈	wgdb
猓	qtjsc
蚛	jkhh
加	lk
矀	htmt
肌	em
狦	qtmjx
囑	knij
詌	yafg
尶	gqal
很	tve
眝	hpsh
盹	hgb
䨚	fqrn
饸	qnwk
聹	bpns
寚	pgrmf
撉	ybtr
煹	ofjf
裡	pujf
褓	puwsd
䑼	teqt
㟄	mudh
潖	iggc
㬢	jugt
溬	iudc
燦	ohqo
辸	epv
粏	odyya
㹓	trfq
碙	dmum
皦	rryt
啦	kru
羸	ynkyh
沂	irh
贂	mccey
䜦	yaqjs
䰬	rqck
誗	ytjh
䄹	twtfe
㚲	vhkg
瀥	inyk
栐	syni
姛	vmgk
嚎	kyp
黔	lfon
枥	sdl
咭	kfkg
䰦	rqcfv
宜	peg
蚨	jfw
肳	eqrt
袜	pug
㫴	jftb
鑠	qxrs
崙	mwgai
葅	awwg
㣞	twcq
巫	aww
㜔	vukq
锺	qtgfb
坻	fqa
㹐	twwh
雵	fmdu
噻	kpf
碉	dmf
曗	jogw
偂	wuej
呭	kann
䑺	temjd
䢺	bmbh
穙	togy
鬄	dejr
惉	ihkn
炌	owjh
矏	hthy
崺	mytb
䟡	khqyv
蘠	anhk
悍	njf
㑧	wtbg
晑	jtmkp
㞥	mtyu
䆢	pwrw
枲	cksu
狋	qtfi
氯	rnv
秀	te
牰	trmg
圌	lmdj
弣	xwfy
䖉	hagf
薫	atgou
祟	bmf
瘈	udhdy
㭪	sgey
獯	qtto
孧	xlbf
僇	wnwe
撒	rae
稠	tmfkb
㶽	okmw
哚	kms
庨	yftbo
曞	jday
螁	jvep
桙	scrh
涟	ilp
碊	daat
儌	wryt
䇱	tlqu
廙	ylaw
孔	bnnc
䯮	deer
舕	tdoo
㹛	trdt
詍	yann
込	typi
轧	lnnc
䙬	pumv
䢁	leg
㰊	sfwo
䄚	pygj
沱	ipx
柰	sfiuf
瞟	hsf
匏	dfnn
䋣	txgit
佴	wbgo
䀛	hqrt
担	rjg
栵	sgqj
迧	jhpk
脻	egvhc
坝	fmyp
崇	mpf
蝄	jmun
钴	qdg
遣	khgpu
吘	ktfht
翂	nwvn
泚	ihxn
坔	iff
梞	snny
揽	rjt
氎	lllnu
䙹	gahq
㝠	pjuu
漍	ilag
穯	tfkk
忡	nkh
㸨	trnh
籩	tthpb
諟	yjgh
抴	rann
鄤	jlcb
惦	nyh
柾	sghgj
㺩	gnhh
塳	ftdp
娖	vkhy
䓋	aiqa
冽	ugq
昳	jrwy
吤	kwjh
勡	sfil
訿	yhxn
麼	yssx
銴	rrqf
瓶	uagu
用	et
䶚	hbjyb
碟	dan
醉	sgy
㢲	xxgw
䂅	hxyj
婡	vsww
㮶	sube
㓌	uwgg
蝉	jujfn
楍	skkk
鐓	qybt
稗	trtf
洕	iwegu
㥜	nleg
厄	dbv
乭	dnb
堔	fpws
蛇	jpx
郵	tgab
祼	pyjs
㖭	kgdn
芐	aghu
䣶	sgtd
隱	bean
犵	qttn
稤	tyiy
誦	yceh
轾	lgc
㾆	umfd
䊘	omeg
䯲	decb
佳	wffg
烒	oaag
踀	khkh
槴	sync
晶	jjj
錠	qpgh
㭰	hxgi
銬	qftn
廰	ybfn
楨	shmy
槐	srq
迡	nxpv
惥	vwnu
淕	ifwf
凞	utao
疟	uagd
䤢	qkln
乷	iitnz
禆	pyrf
脒	eoy
泦	invn
䥛	qdhi
摈	rpr
勠	nwel
盙	gehl
琰	goo
燽	ofnfo
貨	wxmu
谇	yyw
烎	gaou
䥆	ydjq
賤	maat
翰	fjw
脫	ewkq
䇘	tgxg
蒔	ajff
达	dp
眷	udhf
㲳	qayw
㘄	ksly
㣔	tshs
穷	pwl
㗢	ktgl
韶	ujv
夭	tdi
榲	slwl
俸	wdwh
㬣	jogf
遦	xfmp
䆑	pwsj
㬊	jefcc
趺	khf
屙	nbs
怏	nmdy
犒	tryk
嗄	kdhtq
倔	wnb
律	tvfhw
泗	ilgw
㡷	ysgd
揸	rsj
徟	tmfk
杽	srh
窓	pwcn
㟾	myvh
柉	stpy
妗	vwy
哕	kmq
㞜	nttv
䂐	tdbm
貊	eed
盿	hyy
䆌	ttdya
毑	xgub
遹	cbtp
溷	iley
鞦	afto
䂡	drgg
迶	depd
栟	suah
敜	wynt
赕	moo
䅌	tkeg
㛺	vujgo
㢃	yyve
硣	dftb
腊	eaj
傊	wkmy
殀	gqtdq
洒	is
袉	pupx
剬	mdmjf
挓	rpta
䦃	qafju
么	tc
㝜	pajf
侩	wwfc
羌	udnb
㸠	thgq
薀	aill
㹫	qtgw
灜	iyny
绷	xee
營	oopk
锈	qten
㵈	iivd
祉	pyh
铳	qyc
硏	dftfm
朙	lwme
捝	rukq
蕮	avqo
孴	bbbj
豢	ude
匿	aadk
闹	uym
䦹	bfhd
嵩	mym
麭	swwnb
萸	avw
吐	kfg
誊	udyf
迖	dpi
筣	ttjj
疷	uqay
㐐	vcnb
辍	lcccu
酑	sggf
䛬	yqrme
墊	fuff
邛	abhb
䀅	pyfl
伯	wr
稐	twgan
晌	jtm
樳	svaf
甝	hamf
㣃	xycx
绍	xvk
徍	tffg
蛠	jlllu
渐	il
碚	duk
鈏	qxhht
拤	rhhyf
憾	ndgn
煃	odff
韺	ujad
喢	ktfv
誝	ywyk
滨	ipr
憗	swwn
䎔	ngefx
老	ftx
拈	rhkg
抰	rmdy
羑	ugqy
䎇	teng
䉠	ttmt
埢	fudb
闶	uymv
墥	fujf
楼	sov
䖈	haxv
蛓	faji
㜦	vvaf
笘	thkf
襪	puat
號	kgnm
晡	jgeyq
眗	hqkgn
瓞	rcyw
榄	sjtq
䄻	tiqn
洦	idjg
莟	awykx
崈	pfimz
䏧	eqqy
峋	mqjg
仇	wvn
砝	dfcy
䔭	apne
䆛	pwka
埳	fqvg
罀	rmiq
颰	mtjcv
胒	enxn
铑	qftx
㝈	xyxbh
䐅	entd
铵	qpv
䢒	uqpi
莪	atr
癧	udth
槰	stdp
濌	tgjj
垮	fdfn
幪	mhae
匥	acak
溝	ifjfa
胠	efcy
鉘	qxjh
旁	upy
䇳	tdnt
智	tdkj
䑹	tepc
筽	tkgd
补	puh
儜	wpns
㓓	ufmf
恺	nmn
萵	amnk
踽	khty
篃	tnhfi
敽	tdkc
㜏	vkmy
菪	apd
脵	ekgd
㑋	wmag
蛽	jmy
㺃	qtak
速	gkipv
凛	uyl
凭	wtfmb
㧐	rccy
䘿	punm
铦	qtdg
崨	mgvh
噂	kusf
䠉	khpn
朴	shy
氠	rnjh
拞	rrgg
盐	fhl
嫔	vpr
䉈	taet
䨑	fgxw
凸	hgm
䇉	udge
㥣	dffn
柑	saf
厣	ddl
圯	fnnd
䊚	ownp
渦	imnk
蜢	jbl
阃	uls
磮	dmwa
㲐	tfnni
蛹	jceh
㩀	rhayc
偖	wftj
宁	ps
笕	tmqb
箍	tra
㒳	mhty
鉸	quqy
浝	idne
倽	wwfk
峔	mftxc
笻	tabj
玁	qtkt
䭁	rrwe
䤼	qriyh
㛄	vyey
舠	tevnc
崴	mdgt
痋	ujia
褿	pugj
俾	wrt
仙	wm
零	fwyce
龛	wgkx
嫽	vdui
㷑	osff
樰	sfvg
㒖	wajy
㔘	bmln
鄼	fwfbq
癁	uttt
瞄	hal
奢	dft
氓	ynna
參	cccen
韽	wynj
猜	qtge
恌	niqn
両	gmmk
扴	rwjh
鍤	qtfvi
猏	qtye
䘐	tlvw
啘	kpqb
鉖	qtuy
㓛	avn
菜	ae
㯁	sbuk
䅞	tjgfd
䭳	tvrj
鎾	qjlg
薳	afkpg
昒	jqrt
㞉	dnua
隍	brg
哆	kqq
攽	wvty
贺	lkm
诘	yfk
㖮	kwga
勢	fwfl
㑼	wltk
燅	fwfo
鞀	afvk
睫	hgv
椂	sviy
瘩	uaw
䪟	gmhg
绚	xqj
襣	putj
援	ref
檩	syli
艘	tevc
䕪	ailf
愻	btxn
婬	vetf
䆳	pwep
䥑	qswq
允	cq
衼	pufc
垔	sffg
愽	ngef
虪	hamo
胻	etfht
鍗	quph
銹	qtena
哑	kgo
朕	eudy
堷	fujg
㛾	vdgt
抻	rjh
弍	afdx
粂	qyou
㪈	ffhc
藣	alcx
臫	thnn
喑	kuj
盰	hfh
慧	dhd
麮	swwct
嘖	kgmyu
芿	aweb
耋	ftxf
簇	tyt
尉	nfif
刳	dfnj
苳	atuu
踣	khuk
䆁	tlffj
睝	tqthb
枃	squg
畔	luf
䰪	iwec
惹	adkn
媶	vabg
譎	ycbke
右	dk
疰	uygd
嵫	mux
㚁	fffq
键	qvfpg
窴	pwfw
瓍	gbdp
趔	fhgj
㺈	qtbj
窧	pwhj
小	ih
打	rs
㪄	xjty
萠	aeef
陿	badw
恏	vbnu
持	rf
毜	tfnin
從	twwhl
埅	byff
䯬	ylkff
惋	npqb
饜	djee
溠	iuda
椓	seyy
䏚	eitt
栲	sftn
砠	degg
箻	ttvh
湊	idwd
厼	ciu
盈	ecl
鉑	qrg
错	qaj
玚	gnrt
佪	wlkg
宀	pyy
䇍	ukhy
訌	yag
熿	oamww
玌	gnnj
禲	pydy
鎕	qyvk
蝙	jyna
烥	oahh
諽	yafh
苘	amk
澴	ilgev
靕	ghge
㘣	lked
阒	uhdx
䁒	hkbg
舤	temy
呃	kdb
呶	kvc
笯	tvcu
霶	fiuy
䁈	ynthx
凣	hmv
䪈	afkpa
辙	lyc
㐰	wkg
䒄	tepln
瘴	uujk
倏	whtd
橿	sglg
羾	nagi
㢵	xwgk
虖	hath
釕	qbhy
筨	twyk
缦	xjl
鋲	qrgw
漎	itwh
䅵	tugo
冏	mwkdr
邪	ahtb
佔	whkg
䉻	oqan
粔	oang
䪰	ujun
苦	adf
秬	tang
侺	wmwn
禞	pyyk
䨝	fgef
汷	itye
亏	fnv
嚗	kjai
蔮	alag
蕕	aqtg
黴	tmgtw
匉	qguh
㮗	cbtsm
酋	usgf
䇲	tguw
䟤	khnt
暏	jftj
㦚	unuh
㡝	mhtp
㽥	lcbsg
忮	nfcyn
剟	cccj
㺍	qtpw
阆	uyvo
矹	dgqn
襥	puwy
炝	owb
诽	ydj
睽	hwgd
䫿	mtjke
灞	ifa
㯒	sehq
炴	omdy
㕈	dyei
楦	spg
蹫	khck
㯼	safl
暤	jrdf
涸	ild
宇	pgfq
悚	ngki
簼	trffo
蜗	jkm
匔	qtmkf
寀	pesu
譣	ywgw
畗	ylfa
巾	mhk
南	fm
詎	yangg
漜	issf
翹	fffn
䘫	vkye
烹	ybo
牴	trqy
臔	eahm
㰘	sxga
䑫	teuag
䟶	khwfq
㲲	lllnk
㘇	koos
炔	onw
賷	fkkm
擙	rtmd
捄	rfiy
鉗	qafg
磱	dool
鞬	afvp
璄	gujq
攂	rlllw
㓔	utmf
䪅	aflj
尣	wqbm
鋶	qycqn
䍲	udvq
蕅	aijy
廹	rpd
莅	awuf
釬	qfh
初	puv
旐	ytiq
铓	qayn
㻙	gyce
笚	tlj
攬	rahq
邸	qayb
窇	pwqnd
蒃	axeu
敠	cccc
凡	my
䔿	ausf
㥇	naaty
莧	ahqb
犤	trlx
吷	knwy
犟	xkjh
级	xe
炮	oq
迃	fnpv
仔	wbg
䢐	egpd
稱	temf
䑇	errm
帍	ynmhz
辈	djdlk
眃	hfcy
册	mm
㬏	jgkh
懺	nwwg
爡	oajj
冇	dmb
獉	qtdtn
蒋	auq
㑭	wlgj
谈	yoo
䖶	jey
疦	unwil
怉	nqnn
幼	xlnt
狙	qteg
秹	twtfa
䊨	ynkm
鋆	fquq
肽	edy
䝜	eect
譹	yype
毟	ittn
葹	aytb
扗	rfg
寸	fghy
嵅	mdgtf
姏	vafg
蠶	aqajx
靂	fdth
晣	jrrh
獧	qtlee
竦	ugki
㛳	upmv
嶘	msaa
㝄	ybgn
㵑	ilkm
痵	utbd
廕	ybwc
璻	gnyfh
罗	lq
氻	iln
䶌	thlnu
絷	rvyi
媃	vcbs
煜	oju
靅	ffcm
馫	tjtj
鉆	qhkg
腄	etgfw
夈	tou
㛧	vmdg
鉋	qqnn
冨	pgkl
㩑	rgdd
鑆	qogfs
㽏	iwgf
知	td
債	wgmyc
蛟	juq
慦	fiyn
仝	waf
辟	nku
嗞	kuxx
鬕	dead
蟼	aqkj
矕	xyxhz
咓	kgnn
柘	sdg
褾	pusi
䶛	gqjb
獅	qtwhs
榗	sgoj
椌	spwa
僎	wnnw
堅	ahnf
缤	xpr
䔦	astu
楱	sdwd
䠂	sskh
馢	tjaa
畅	jhnr
偓	wngf
髥	demf
挬	rfpb
考	ftg
醋	sga
趾	khh
熶	ojbc
釥	qiy
桫	sii
纺	xy
挔	ryey
阇	uftj
荛	aat
偙	wuph
蟫	jsjh
裺	pudn
阖	ufc
懎	nfwk
缱	xkhpt
裾	pund
摜	rxfm
啀	kdffn
猌	swwd
愸	swwni
㜍	vyvk
煎	uejo
涊	ivyn
㘱	fmfg
盓	igfl
犻	qtgh
焝	oqaj
䟀	fhua
㿜	uthaq
巋	mwnh
蚟	jgg
膖	etdp
㒢	wwgah
瞮	hyct
䂒	tdfk
擉	rlqj
瓾	tvgn
﨧	qftb
䚎	dwvq
鍶	qlny
㒔	wlqj
犍	trv
䚰	yxn
陈	ba
㶟	illi
竪	ahnun
鏚	qdht
佊	whcy
䖱	jagg
滖	iyke
睟	hywfv
拪	rsg
磉	dcc
賹	muwl
婵	vuj
焲	oywy
㫩	fajf
㑷	wcex
䗾	jjxo
址	fhgd
䗤	jyvh
箈	tick
娿	bskv
㮊	scbsr
䟥	khct
齝	hbck
窅	pwhf
箤	tywfc
䗋	jafs
戣	wgda
秋	to
呦	kxl
鄙	kfl
暛	juda
贯	xfm
貶	mtpy
虴	jtan
瑘	gbbh
艻	alb
桮	sgik
鋅	quh
袕	pupw
笍	tmwu
硅	dff
㫼	jrmj
慒	ngmj
玬	gmygj
釐	fitf
䅜	ttgfd
䤫	qmwn
琸	ghjh
臨	ahnk
囱	tlqih
礡	dagf
藸	aefj
垷	fhqn
袖	pum
蜊	jtj
灳	qoi
庍	yrk
僨	wfam
苟	aqkfs
峉	mtkf
梗	sgjq
獞	qtuf
迵	mgkp
衻	pumfd
椝	fwms
筢	trc
吶	kmty
暡	jwcn
趗	fhkh
踺	khvp
搤	ruwl
跫	amyh
䓽	aynb
恶	gogn
㢙	yakl
熅	olwl
鍂	qqgq
䨬	fiss
鬌	dede
戜	akgde
朷	svnv
烂	oufg
箧	tagw
瀹	iwga
㣶	tylg
憒	nkhmz
稔	twynw
戏	ca
䦿	bkhh
逎	sgpd
㕉	dwgk
㬵	euqy
嗔	kfhw
㴏	ipwg
㻦	gjmy
貄	eevh
鍱	qans
卜	hhy
嶹	mfnf
䫸	mtjvi
苃	adcu
褧	boye
㒸	ueu
憩	tdtn
㱟	gqhc
蒯	aeej
嫲	vyss
雨	fghyu
祜	pydgq
䫼	mtjwr
䕁	adjs
蹊	khed
木	ssss
或	ak
㷦	boou
䢿	pvbh
欜	sgke
谜	yopyb
耴	bnne
姳	vqkgx
菇	avd
䄍	pyaj
轴	lm
锶	qln
拍	rrgo
䇴	tsf
旚	ytsi
罴	lfco
湿	ijo
袿	puffu
弮	udxb
癛	uyltt
铘	qahb
㿧	rfnfj
晼	jpqb
碐	dfwt
㲗	ebtn
琇	gten
潏	icbk
瓢	sfiya
䞵	fhcc
圫	ftan
玔	gkhq
㦹	jgqa
氽	wiug
䔸	adddz
宅	pta
蟧	jool
㘠	lnte
霝	fkkk
㒡	weri
阞	bln
葙	ash
㴛	igct
圹	fyt
唁	kyg
鄝	nweb
滠	ibc
癿	rnn
链	qlp
娷	vtgfd
㮠	saps
䆫	pwqn
佛	wxj
憱	nyin
晹	jjqr
䝯	mtbn
鄖	kmbh
圮	fnn
柔	cbts
膧	eujfa
筋	telb
提	rj
蓝	ajt
覜	iqhq
㓒	uawnp
郊	uqb
㒒	wogw
䧆	bawy
惼	nyna
钖	qnrt
㽦	ooplw
挴	rtxu
黻	ogucj
闪	uw
璎	gmmv
牗	thgh
此	hx
䙶	spey
氞	rngw
啱	kmdg
营	apk
蹿	khph
鉩	qwiy
坹	fpwy
籐	teui
刼	fcvy
寘	pfhw
禩	pylw
昲	jxjh
积	tkw
瀓	itmtu
襤	pual
镓	qpe
㼏	evry
䢩	gktp
蓌	awwt
开	ga
䓜	aiqy
蝡	jdmdy
渠	ians
篬	twykb
㜲	vyny
㼴	jmhns
寊	phmu
䏗	ernn
䑯	teutz
雳	fdlb
橏	sudk
劢	dnl
蒝	adri
䄌	pycc
襔	puay
灯	os
菏	ais
匮	akh
铒	qbgg
椥	stdk
鎮	qfhwi
杊	skh
䬙	mtjm
墫	fusfd
泣	iug
㰄	smaa
櫁	spnj
熥	ocep
彝	xgo
扺	rqan
藩	aitl
厈	dfk
皨	rrrfy
縻	yssi
屴	mlb
墶	ffup
澿	issi
莸	aqtn
複	puttu
䏷	ejfh
淿	irmh
壄	scbf
毺	tfnjz
匚	agnq
㤋	nwvnj
㻴	gjlc
塧	fuwl
㻷	ggmi
扶	rfw
疜	ughig
翓	fkng
蒒	awnhk
䬥	awye
冖	pyn
孬	giv
玲	gwyb
㘌	khaj
理	gj
㵒	ixjm
裏	yjfez
䝲	mnyu
漄	imdf
莁	aaww
詙	ydcy
苿	afiuc
霕	ffcnk
泂	imkg
挰	rkgg
蠆	ajmj
僠	wtol
梕	svyn
㸲	trtfo
湥	ipwd
坐	wwf
濞	ithj
吓	kgh
疼	utu
䅝	tpwa
狷	qtke
襄	ykk
抄	rit
硯	dhqn
䣈	kckc
㳰	iyca
瑚	gde
孮	bpfi
賥	mywf
菂	arqy
鞽	aftk
锭	qp
㴇	iiiyg
䤀	sgakm
悥	ynu
孙	bi
祅	pytdp
陹	btaj
潟	ivqo
暸	jduid
䬈	mtjq
穼	pwsu
画	gl
侬	wpe
踅	rrkh
佅	wfiy
䘥	pulhk
眬	hdxn
䧛	bupy
吚	kvtt
㑰	wxey
裨	pur
畆	ylcy
壽	fnaf
甩	en
燨	ougt
芾	agm
貍	eejfu
蜉	jeb
桿	sjfh
袷	puwk
㵡	ifqnn
嵉	myps
忾	nrn
迸	uap
熃	cbtod
搎	rbti
唎	ktjh
溙	idwi
睂	wwhh
烰	oebg
㼦	amyny
髨	defq
憚	nkkf
䅛	tjjg
褁	jseu
佷	wvey
䋅	xrhh
衏	tfqh
童	ujff
秽	tmq
滕	eudit
䓅	airj
殇	gqtrn
冧	pssu
䓷	aith
垤	fgc
膪	eupk
㘆	kfkf
靡	yssdp
夌	fwtu
䔖	abft
宓	pntr
玩	gfq
﨑	mukh
脭	ekgg
怰	nyxy
帔	mhhc
钏	qkhj
珈	glkf
㦑	nnbt
㪨	uduc
兗	ukqby
湮	isfg
厵	driif
道	uthp
䙂	puwnz
羪	udyeh
芖	adu
彔	xgiu
浀	imag
䇟	tqlb
賚	swwm
煐	oamdu
熰	oakk
䓠	aijf
㛙	vuh
犎	fffhi
卶	qqbhb
婒	vooy
嵢	mwykv
泙	iguh
醗	sgwq
䀱	htdh
鈮	qnxn
鍾	qtgfr
㐛	wdkn
蔻	apfl
朦	eap
稓	tajg
竏	utfh
韪	jghha
坁	fqan
菐	oguy
䀏	qhd
粤	tlo
缄	xdg
忈	fnu
鈇	qfwy
媠	vdae
㣡	twkh
璏	gxgx
䀳	hgki
衎	tffh
纬	xfnh
裱	puge
䓞	aynd
菠	aih
袝	puwfk
䑩	tedg
㹤	qtfc
滥	ijt
酨	fasg
哰	kprh
㼆	gooy
秗	ttdy
㓬	udvj
芛	avtr
汯	idcya
賎	mdxy
詜	ybhc
趻	khwn
劽	gqjlb
芳	ay
絭	udxi
龺	龺
糥	odmj
形	gae
帢	mhwk
浫	ipwff
椛	sawx
篙	tymk
昍	jjgw
䘸	puyy
卹	tlbh
甖	mmgn
襎	putl
艉	ten
㢇	yyd
䧂	bvkg
㚠	dugo
淣	ivqn
蝻	jfm
㢮	xtbn
蛘	jud
衵	pujg
䦉	dlg
鞭	afw
箚	twgjp
镡	qsjhd
榻	sjn
㟮	mpwd
型	gajf
姫	vahh
讱	yvyy
䨴	fogf
讶	yah
窟	pwn
㟝	mukg
㩽	gkic
羚	udwc
漧	ifjn
斂	wgktx
矸	dfh
讫	ytnnj
遉	hmpi
䎲	bnna
伒	wrh
憁	ntln
啽	kwgaa
䗬	tdhja
磧	dgmy
溑	iimy
竿	tfj
陶	bqr
稧	tdhd
䎝	ftxnv
肄	xtdht
榙	sawk
垡	waffv
㧈	rxn
㑜	wrrh
征	tgh
㔺	fafjb
㤅	aqnu
㬃	jcko
䑡	tecy
㧋	rdy
侔	wcr
種	ttgft
䓸	avvf
傠	wyfy
堳	fnhg
䯷	deada
佚	wrw
㞨	mbg
百	dj
岔	wvmj
㧿	rwwh
蔏	aumk
悻	nfuf
晕	jp
掄	rwgaz
飈	mtjom
狔	qtnx
㫃	ywy
花	awx
㗜	kyxl
献	fmud
撗	ramwi
街	tffhi
諈	ytgfh
绐	xck
呧	kqay
跶	khdp
把	rcna
䅺	tsfiq
㔎	btwv
黕	lfoq
猯	qtmjk
杳	sjf
蟝	jias
扞	rfhy
愣	nly
漝	inrg
咫	nyk
聐	bfkg
伜	wvfh
觑	haoqd
㥐	wgknt
悃	nls
鏱	qujh
婆	ihcv
炉	oyn
泔	iaf
䝐	ebde
璦	gept
䄰	tahtb
禜	oopil
㜖	vgmj
躂	khfp
浗	ifiyi
拇	rxg
菗	armf
撩	rdue
牝	trx
蠩	jyfj
楆	ssvg
汪	ig
箩	tlq
妍	vga
恴	yjnu
㐒	vknb
襦	pufj
盂	gfl
淛	irmj
譴	ykhpq
帵	mhpb
纴	xtfgi
訉	ymyy
痻	uqaj
㦟	eejn
瞼	hwgw
散	aet
卷	udbb
浔	ivfy
浿	imy
潰	ikhm
郀	dfnb
郮	mfkb
鍪	cbtq
䜘	yaqt
䐵	eamw
扷	rtdy
狣	qtiqe
磙	duc
旕	ywux
窹	pwnk
禌	pyux
颩	mtjep
㬉	jdmd
䰫	rqcq
埤	frt
䗱	jogy
䁺	hlffs
荀	aqj
界	lwj
謞	yymk
熄	othn
忿	wvnu
柢	sqa
諗	ywynn
踝	khjs
䔰	apgl
摬	rujq
愢	nlny
婻	vfmf
焢	opwa
㵬	ieel
㕘	cccie
碗	dpq
肑	eqyy
犆	trfhq
䂑	tdhx
燥	okk
霒	ffcn
玏	gln
蠈	madj
敇	gmit
帥	wnnht
䙱	punj
荷	awsk
庸	yveh
淰	iwynm
辖	lpdk
蕻	adaw
㵖	ivki
首	uth
齉	thlez
稼	tpe
䐎	ejgh
㧓	rrcy
勝	eudl
扼	rdb
鋕	qfny
䣔	imbh
逜	gkpd
洱	ibg
妐	vwcy
耫	digm
嫗	vakk
腂	ejsy
㻛	gjqr
聩	bkh
兑	ukqbv
窯	pwuo
協	flllr
玐	gwy
齣	hbqk
辵	ehu
翙	mqng
葏	aivh
瀿	itxi
灱	ovn
㑣	wssy
鏪	qgmju
时	jf
䛾	ygxi
祶	pyut
昖	jwcy
非	djd
眧	hvkg
窜	pwk
㭇	scqn
迥	mkp
湁	irwk
䐙	eafh
辐	lgk
淐	ijjg
疳	uaf
韦	fnh
㯾	sgmp
濡	ifd
狂	qtg
殒	gqk
甹	mgnb
唬	kham
燰	oept
粺	ortf
亱	ywjg
撔	rjyi
咽	kld
议	yyq
助	egl
碄	dssy
憽	naqn
搓	rud
拄	ryg
䘧	pumd
䛆	ymg
午	tfjd
㨍	fffr
䁏	hsvg
訅	yvn
蹦	khme
畚	cdl
錿	qham
揁	rhmy
愉	nw
虙	hant
丒	vygf
瘀	uywuk
热	rvyo
謴	yxfm
踖	khajg
彤	mye
謶	yyao
靝	gero
㩚	rape
姖	vang
蠕	jfdjl
詘	ybmh
棫	sakg
脱	euk
㓶	dhvj
㤾	npws
齅	thld
旮	vjf
岠	mang
锤	qtgfn
述	syp
粨	odjg
㳇	iwqy
朳	swy
盆	wvl
腀	ewga
炁	aqouv
吣	kny
盌	qblfv
䞂	mdmd
洃	idoy
傀	wrq
䗘	jfclk
䖴	jiqna
䘨	puuq
銦	qldy
桧	swf
娝	vgik
缮	xud
添	igd
䍪	udgs
摑	rlag
胵	egcf
轱	ldgu
訫	ynyp
仜	wag
璓	gate
盔	dol
㵚	iwqq
稬	tdmd
舙	tdtdp
審	ptolq
迓	ahtp
眾	lwwu
无	fq
㾣	uqde
幀	mhhm
歭	hffy
㓵	kkfj
椤	slq
痨	uapl
厕	dmjk
㤯	nmwk
眏	hmdy
倖	wfuf
䊤	osjh
臾	vwi
郆	fkbh
㵞	itonj
抂	rgg
箱	tsh
倹	wwgw
㨓	rpwht
嫸	vudk
硚	dtdj
亳	yptan
祆	pygd
囧	lwmv
舁	vaj
吴	kgd
庂	ywi
妆	uv
㳎	icah
逵	fwfp
珑	gdx
擗	rnk
吩	kwv
䠦	khtj
䑚	tdeg
㓜	xvnl
䨳	fhqqr
礻	pyi
㺯	gdu
謀	yafs
瀮	ifss
䇈	ucfg
箭	tue
漾	iugin
讼	ywc
敓	wkqt
孃	vyke
唡	kgmw
蔴	ayss
羠	udgw
迟	nyp
䐞	exuu
䉒	ttol
穴	pwu
姎	vmdy
褮	oopem
曛	jtgok
㕊	dgey
翕	wgknh
隫	bfam
槂	sbti
凪	mhdj
瘇	utgf
橄	snbj
眹	hudy
䇷	tklj
瑞	gmd
飍	mtjjc
朻	snhho
敌	tdt
炯	omk
钚	qgiyd
人	w
褜	eqne
唔	kgkgj
瑇	ggxu
砸	damh
懅	nhae
腨	emdjg
㘽	fafdg
㷭	tdhoz
楁	sptk
徔	tapy
栻	saag
邥	pqbh
葸	alnu
忣	neyy
蜻	jgeg
懃	akgnm
壩	ffae
䑐	ahni
羵	udfm
㿯	wgkcq
籴	tyo
嘔	kakk
磅	dup
揺	refb
擄	rhalg
扃	ynmk
赛	pfjml
躤	khaje
㯪	sfwc
岵	mdg
腃	eudb
砱	dwyc
焌	ocwt
纭	xfc
箇	tldfv
䅫	tyji
牭	trlg
裚	rrye
祧	pyiq
撖	rnbt
舓	tdjr
焭	oopm
必	nt
䰌	dethw
㒻	jhqb
誷	ymun
譛	yfwj
鬡	deps
楇	smnk
㻵	gnbb
煈	omtj
朤	eeee
蜏	jten
䰍	desi
嵂	mtvh
哫	kkhy
鞲	afffs
廳	ybgnb
抶	rrwy
佬	wft
沇	icqn
㞤	mwu
㰔	soyc
瓲	gnynh
茢	agqj
䑭	teia
雲	ffcu
鍠	qrggs
斱	ftjrs
彦	uter
儏	whqo
房	yny
芶	aqcu
杁	styy
蜘	jtdk
汐	iqy
类	od
袌	yqne
啐	kyw
脧	ecwt
㬳	etfh
儡	wll
旵	jmj
畲	wfil
啰	klqy
㓨	dwwj
犪	trut
韷	ujbm
垌	fmg
烊	oud
齽	hbsi
伭	wyxyj
㺮	gfnn
笇	tyhu
场	fnrt
昻	jabj
媧	vmnk
藭	apwx
澡	ik
邨	gbnb
錍	qrtf
㐗	ftxnd
㫊	ytsk
庈	ywyn
䢷	mybh
訛	ywxn
涬	ifuf
䒔	awu
莏	arit
檯	sfkf
溱	idw
屪	npdi
珂	gsk
硓	dftx
詽	yftf
鬍	dedeq
擥	ahnr
洌	igq
㓠	hkjh
䎱	dilx
稜	tfwtk
孻	bvhl
茤	aqqu
鞷	gkmf
逤	iitp
灐	iooq
龣	wgki
璆	gnwe
䎽	bqaj
䗙	pfjjv
㟈	mfiye
棆	swga
㑠	wjcf
呢	knx
爦	oahq
蚮	jway
襈	punw
䋈	vcxi
漫	ijlc
中	k
䵏	amwec
屵	mdr
微	tmgl
梥	pwcs
翘	atgn
痆	unxv
崞	myb
䟬	khrg
惯	nxf
蟳	jvaf
踤	khyfe
橤	nnns
沬	ifiy
始	vck
㻼	gsjh
胃	le
缫	xvj
䣩	sggn
䝽	mdffa
尟	jghtm
覂	stpu
臓	eadt
狺	qtygz
馅	qnqv
劧	rlnm
牐	thgv
畃	jhqy
熎	oerm
秤	tgu
鐿	qujn
鞤	ffffy
㕚	cyyi
㒹	fhww
酜	sgfw
衆	tlti
惒	tknu
客	pt
㶚	isae
㛽	vpoy
妑	vcnw
湟	irgg
绸	xmf
惐	nakg
珘	gtey
㞺	mtdu
剹	nwej
肝	ef
劋	kkkj
妶	vyxy
楰	svwy
郑	udb
櫙	saak
仅	wcyr
淺	iaat
坶	fxg
巳	nngn
氊	tfng
稇	tlsy
䁶	hryt
㛼	vtfv
銂	qythg
虳	jqyyd
蒁	asyp
乐	qi
個	wldg
刌	fjhv
䟁	fhvs
涠	ilfl
螆	juxx
㓚	ajh
㞈	dnya
䪨	ujqy
䬤	nwye
妬	vdg
蛝	jvey
癦	ulff
鞂	afty
帊	mhcn
㢭	xhcyi
捹	rdfa
㱓	hwyc
砲	dqnn
傪	wcce
㧹	rjgf
譻	mmyf
揲	rans
丐	ghn
棄	ycas
贰	afm
㸟	thgjg
粆	oitt
惧	nhw
詷	ymgk
㮹	sgctj
墺	ftmd
自	thd
剝	xgij
麻	yss
謔	yhagy
蘣	aamg
进	fj
祫	pywk
枑	sgxg
礅	dyb
䎡	dmjot
绑	xdt
纷	xwv
嵀	msyg
皮	hc
蹅	khsg
斃	umix
鏣	qyao
脲	eni
䵠	lfoy
陵	bfw
彐	vng
悺	npnn
係	wtxi
剃	uxhj
远	fqp
馡	tjdd
埂	fgj
㼨	wynnt
鉞	qantl
陜	bdwwf
狉	qtggj
舡	tea
㞶	myy
鐞	qvaf
耓	dish
簭	tawk
终	xtu
䕮	afuoj
竩	upeg
刱	fjvw
陑	bdmj
巟	ynqb
㬀	jybgz
牻	trde
棩	sjggc
㧀	yney
洔	iffy
蒌	aov
菘	asw
亯	yjfl
淾	qiup
訕	ymhs
鄐	yxlb
貾	mqay
诧	yptab
笆	tcb
彥	yder
怮	nxln
涴	ipqb
宏	pdc
窗	pwt
瑀	gtky
酐	sgfhm
胋	ehkg
䣧	sgayv
纸	xqa
䖤	qbju
䘴	pusc
槅	sgkh
钔	qun
烣	odoy
颲	mtjjw
伷	wmg
䚐	tdkq
扎	rnne
慎	nfhf
黀	ysscl
豿	eeqk
忓	nfh
饵	qnbg
奡	dhdju
銅	qmgkq
疻	ukwi
尸	nngt
溴	ithd
琭	gviy
佱	wfhf
浖	iefy
怫	nxj
尖	id
扪	run
甃	togn
宲	pksu
砿	dycy
匲	adkk
阤	bbn
槿	sak
荧	apo
忶	nfcyc
沄	ifcya
擘	nkur
㒃	wafm
亘	gjg
櫪	sdth
枳	skw
醹	sgfj
羔	ugo
冪	pajh
婜	ahnv
㓏	umwk
蒽	aldn
㠵	ynmh
宙	pm
琥	gha
諫	ygli
肱	edc
楹	sec
礨	llldg
蘫	aial
榱	syk
意	ujn
䩰	afkb
亝	cccf
㭝	ssvb
䀇	drml
㮫	spdky
葍	agkl
鑯	qwwg
探	rpws
泰	dwiu
䕯	asfy
㖨	kviy
䕔	atqho
徺	tffq
蛾	jtr
妽	vjhh
禉	pyug
渲	ipggv
觅	emq
䴼	swwae
䵵	thdo
氛	rnw
栴	stmy
猵	qtya
嘃	kyvh
㜆	vopy
綔	dfni
足	khu
䃼	pyhy
回	lkd
㸞	thgn
掳	rha
挹	rkc
蹹	khwnc
謎	yopy
萿	aitd
導	uthfg
碡	dgx
鐷	qaas
苹	agu
帚	vpm
颪	ghmj
帹	mhuv
证	ygh
桋	sgxw
糨	oxk
䍆	rmps
濙	iooo
䐽	eamy
䶏	uxhjx
禃	pyfhh
獊	qtwkc
銏	qmmg
绖	xgcft
虲	jhy
䝮	myxy
佺	wwgg
㛏	vfiy
鑛	qyaw
睻	hpgge
搵	rlwl
鏌	qajdb
啄	keyy
踴	khcl
䬄	mtjto
撰	rnnw
䞦	fhtkf
襶	pufw
呼	kt
滱	ipfc
醧	sgak
卋	faf
袨	puyx
滘	ipwkh
㩇	rvfg
戢	kbnt
淓	iayn
䴯	swwr
㶣	fouy
菳	aqf
鬈	deul
渉	ihitt
窑	pwr
卓	hjj
䀊	inwl
阛	ulgeg
睰	hadk
棈	sgegm
㹦	qtvk
黚	lfofq
㱧	gqpb
俰	wtkg
䨓	flkf
爌	oyaww
䏸	egkg
䇞	taff
丙	gmw
榢	speyi
嘒	kdhv
鄅	tkmb
㓼	swij
朵	ms
堃	yyff
㻸	gaqj
妯	vm
菓	ajsuk
令	wyc
厎	dqayh
焊	ojf
耶	bbh
嚒	kysx
尺	nyij
䖃	adkkp
憢	nffq
囿	lde
衳	puwcv
赲	fhlv
䔺	abde
贌	mogy
掔	ahnra
㘊	kfyg
弫	xahhy
奭	ddjj
牕	thgnh
㔤	ptol
滋	iux
䟞	khit
㻤	gaqk
兊	wcqb
赸	fhmko
盅	khl
钅	qtgn
瀍	iyjfx
㠅	mttt
襐	puqe
趍	fhqq
迬	ygpd
弛	xb
嵷	mtwh
矻	dtnn
㤢	ndeg
秚	tufh
䯺	deqk
獽	qtyet
邠	wvbh
胁	elw
燇	ousf
槼	fwhs
㣕	tdy
皗	rmfk
茊	argf
獡	qtvo
荝	amjjw
䈑	tmnk
铨	qwg
䌼	xukq
砄	dnwy
蹤	khth
蠴	jalj
䟂	fhjc
院	bpf
筌	twgf
垶	fuh
湬	toiu
魕	rqct
俑	wce
冔	jkgf
稫	tgklv
胡	de
旒	ytyq
鑎	qakm
胔	hxmw
傄	wduh
昡	jyxy
鍳	ahnq
哃	kmgk
凙	ulffs
昪	jcaj
肼	efj
㨬	rfke
漡	itjr
㗰	ktwh
搴	pfjr
燉	oybt
㼥	ftgn
劸	ffln
蘡	ammv
忧	ndn
䟕	khcy
肭	emw
黍	twi
产	u
筳	ttfpl
㢰	xhcyz
㔐	tgdj
昜	jgqr
琎	gfjp
㹝	qtqa
鏠	qtdp
羆	lceo
奼	vtan
蔀	aukb
怺	nyni
㶳	vfho
廩	yylt
穡	tfwk
佇	wp
㕟	hmac
㧮	rvg
㜴	valh
佝	wqk
寈	pgef
呁	kqug
率	yx
姠	vtmk
鞡	afru
衉	tltk
删	mmgj
哱	kfpb
矨	tdtd
滾	iuke
葡	aqg
脁	eiqn
糍	oux
塄	fly
寞	paj
好	vb
採	resyg
扬	rnr
退	vep
岁	mqu
㼑	gliy
䈇	thjj
䛎	ypwy
吪	kwxn
嚙	khbh
仢	wqyy
烠	odeg
苬	alwu
劥	ymln
砖	dfny
媓	vrgga
俲	wuql
㾮	urgd
诗	yff
课	yjs
瞹	hept
㶼	octd
璮	gylg
䬏	mtjkk
儧	wfwm
㮼	synnt
䃚	dytd
處	hatm
㯰	slfh
疙	utn
世	an
岹	mvkg
鉭	qjgg
靿	afxl
㘪	ftfn
浍	iwfc
庡	yyei
旦	jgf
聘	bmg
蒅	aivss
㖛	dkxb
牵	dpr
縣	hiti
四	lh
惚	nqr
蚏	jeg
啅	khjhh
䄽	tsg
爮	rhyn
帄	mhsh
绯	xdjd
䀾	dchf
珋	gqtb
焯	ohj
芤	abn
钌	qbh
砃	dmyg
疞	ufnv
䣂	dibh
巴	cnh
訑	ybn
喯	kdfa
㢞	ynlw
眠	hna
胛	elh
戒	aak
魅	rqci
轭	ldb
絜	dhviz
蕁	avaf
赑	mmmus
㕴	kpmn
㟽	msfi
䔩	agkt
嗊	kamyc
撍	raqjc
䥰	qynj
垚	ffffp
貓	eeal
颮	mtjn
甽	lkh
鉂	qkqyt
趖	fhwf
叅	cccnr
䈌	tieg
讔	yben
錝	qpfi
砂	di
癔	uujn
炟	ojgg
嵮	mfhw
让	yh
跰	khua
蛩	amyj
楒	slny
瑡	gwnh
㐍	enb
虽	kj
䠔	khue
菆	abcu
都	ftjb
虢	efhm
糄	oynar
塴	fmee
踉	khyex
䇝	tar
甈	thsn
儿	qt
羍	dudj
褈	putf
膤	efvg
复	tjt
䞨	fhff
甓	nkunk
㳴	intf
曉	jffq
釢	qent
躠	awnhn
鑝	qatp
磁	du
贇	ygamh
萖	avqb
崯	mqg
㗤	dhik
㻠	gpwd
挐	vkrj
橐	gkhsr
恿	cen
誂	yiqn
揵	rvfp
復	ttjte
瞑	hpj
垉	fqnn
䗴	jttp
跛	khhch
禤	pylnu
㭍	uasu
醅	sguk
氣	rnou
䴻	tqtt
叹	kcya
涒	ivtk
慓	nsfi
籙	tqvi
傝	wjng
㓋	uawy
卡	hhu
晍	jmgk
鄛	vjsb
搔	rcyjd
㶗	txgi
坉	fgbn
䄕	pyil
㶸	olll
柁	spx
勀	dqln
笵	tibb
哞	kcr
昑	jwyn
鞕	afgq
錣	qccc
㘿	fjfg
滛	ierm
螉	jwcng
铃	qwyc
怔	ngh
㠞	tmgm
莽	ada
愤	nfa
䞟	fhrd
橈	sffq
倒	wgc
币	tmh
瀴	immv
蚆	jcn
㯺	shns
迒	ympv
庌	yaht
㡊	mhqv
湃	ird
忒	ani
皃	rqbl
䬗	jgqj
㤚	ntfhl
嘧	kpn
䟜	khmwj
默	lfodt
怶	nhcyv
鄽	yjfb
恃	nff
鍈	qamd
㱫	gqgim
醏	sgfje
鬽	rqces
牅	nhdh
怵	nsy
場	fjgr
郏	guwb
䢥	ghhp
䊆	vou
琯	gpnn
㯽	spnm
睖	hfwt
䇊	uycy
枟	sfcy
谧	yntlb
夾	dwwi
葆	awk
彚	vpjs
厶	cny
腍	ewyn
鄪	xjmb
㲢	ynmn
㶘	itsj
䢓	pgfp
弐	gafd
旷	jyt
溄	imth
浳	iaeg
珀	grg
蓙	aywf
摃	ramyv
陴	brt
杘	nsi
磈	drqc
吃	ktn
璨	ghq
㔮	akfx
蓵	argh
蚁	jyq
昏	qajf
䎉	ndytq
槨	sybb
楴	suph
蜦	jwgas
弘	xcy
埯	fdj
蒂	aup
挾	rdww
㤖	npsh
䚇	ithq
势	rvyl
沅	ifq
蹉	khuae
玧	gcqn
㮋	sdeb
焈	ynno
祊	pyyn
舮	teynv
䟼	khghv
氷	yii
㴞	iehj
兛	dqtf
霁	fyj
䨋	ftab
癴	uxyr
弩	vcx
吒	ktan
洝	ipvg
徤	tvfp
戆	ujtng
蛌	jrcy
懸	hitn
寔	pjgh
䔞	ayxf
聅	btdy
㷗	tnho
锸	qtfv
㸓	ejf
盒	wgkl
旲	jdu
趮	fhks
䵬	lfoju
辽	bp
瑑	gxey
忰	nvfh
熸	oaqjy
唪	kdw
杦	sqyyj
謇	pfjy
鞁	afhc
瘏	uftjz
䛄	yqbn
畜	yxl
弱	xu
缥	xsf
㴫	ivtb
鈟	qxhh
㥙	nkhn
㐥	qegn
鋡	qwyka
淊	iqvg
嫑	gisv
廫	yene
史	kq
㯹	ssff
皜	rymk
轨	lv
㗦	kbqb
紥	rnxi
礵	dfsh
褖	puxe
詛	yegg
遠	fkep
慘	ncce
肈	ynahb
㟰	mpju
詢	yqjg
蜬	jbib
抜	rdcy
䃯	dirs
糎	odjf
裻	hice
舧	tety
㭵	sqlg
功	al
瞨	hogy
曔	jaqt
㗓	kwnp
珽	gtfp
䔆	aqtf
肞	ecyy
屰	ubtr
贮	mpg
咐	kwf
茧	aju
凜	uylt
翲	sfinu
墒	fum
㑉	wmgq
砥	dqayy
曼	jlc
翤	kman
㓴	dmjjo
攼	fty
谬	ynwef
蒉	akhm
恞	ngxw
晻	jdjn
䓃	akcb
哉	fak
浜	irgw
䇮	twtf
涇	igva
㟹	mbqb
洛	itk
猢	qtdey
㻁	glkg
䠞	khdto
溏	iyvk
锱	qvl
逆	ubt
㬆	jnaj
㨸	rpnm
塔	fawk
鬿	rqcr
毳	tfnnt
玳	gwa
䵈	txts
癟	utha
㡨	mhwg
屄	npwi
諻	yrgg
篡	thdce
俬	wtcyz
笈	teyu
滅	idgt
㤮	qtgnc
遻	kkup
帤	vkmh
堏	syff
锹	qto
痬	ujqr
枍	swgnf
荥	api
嘦	kwsv
㓂	pfqvp
彘	xgx
㚵	vtuy
珩	gtf
碰	duo
孁	fkkv
窷	pwbb
沑	infg
籇	type
阨	bdbn
䩱	afwj
榶	syvk
歵	hgmy
隙	bij
踫	khug
缲	xkk
㿔	ulll
榒	sxuu
釪	qgfh
䤻	qdae
瀪	txgig
䘦	punx
䎆	nwyc
鐳	qflg
㐂	aaab
䏓	efqn
䃗	dvij
殣	gqag
䝎	emdj
㜀	vshg
賽	pfjm
㼧	cegn
眿	hyni
䍁	xuep
㷴	dtto
侽	wlln
摨	rnih
曽	uljf
衶	pukh
钒	qmyyp
卭	abh
䃍	duey
徙	thh
愵	nxuu
檠	aqks
䖑	hamjz
塘	fyv
樴	suaj
鈀	qcnd
㞐	nud
㞄	dndn
嫠	fit
勫	toll
嬌	vtdk
觋	awwqk
葉	aans
㝏	pwjj
钠	qmw
䖧	jjgg
㮷	sdnj
㧊	rgmh
屛	ntfft
䐝	eimy
㳊	ity
蝸	jmnk
嘞	kaf
㰐	sbdp
壓	djefw
溁	iaps
㳲	iidy
㼒	rcyr
䯨	ymkd
荑	agx
虠	uqhm
灀	ifsh
鋄	qgoc
㕿	tkf
翌	nuf
宠	pdx
阗	ufhh
襊	pujc
䁹	hnku
境	fuj
䢔	wgkp
醢	sgdl
誋	ynny
釴	qayx
茉	ags
放	yt
訞	ytdy
控	rpw
㻱	gtdp
甲	lhnh
锖	qgeg
瓿	ukg
謨	yajdg
聽	bgfn
宝	pgy
尴	dnjl
癮	uben
虔	hay
苴	aeg
译	ycf
聠	buah
灬	oyy
㮄	sfqy
䁯	hwgnn
䆾	pwal
燏	ocbk
藞	addd
害	pd
疁	lnwec
泽	icf
埔	fgey
炅	joul
筇	tab
燚	oooo
覓	eh
擩	rfdj
䛡	yqak
跞	khqi
秘	tn
䓺	augd
䘷	puuiq
破	dhc
髛	ymkv
陭	bdsk
坱	fmdy
柸	sgig
䣭	sgdy
貉	eetk
記	ynn
滰	iujq
䄺	tgxw
砮	vcdf
澨	itaw
艔	teyc
殫	gqkf
闵	uyi
櫲	scbe
䕾	akkt
牉	thgfd
撴	rybt
鄂	kkfbh
肗	evg
㸱	trtb
煙	osfg
钹	qdcys
䁔	hefc
蝺	jtky
㞏	ntpi
珴	gtrt
唩	ktvg
蠦	jhal
㥀	nfhg
叆	fcec
仄	dwi
乯	tuhn
䂕	tdxe
踋	khfbp
籓	titl
䀔	hvyy
㮚	hlws
䍈	rmghh
硿	dpwa
烕	dgot
恧	dmjn
卧	ahnh
曫	xyxjn
冿	uvfh
瓂	gafl
強	xcjy
嶑	mqje
䟧	khlg
婣	vjgg
漂	isf
蔤	apnm
和	t
柙	slh
䛍	yxjh
妤	vcbh
瘉	uwgjc
読	yfpq
㾢	usww
㯷	swoy
挿	rtfjm
鎼	qhar
燒	offq
浌	iwat
亸	ybuf
蕔	afuc
邉	thpp
窈	pwxl
䝴	gkhm
㩆	ryin
仗	wdyyl
硺	deyyf
䞍	mgegn
目	hhhh
揠	rajv
㙨	fxxt
㺄	qtwjb
㰂	sptl
捓	rahb
瑷	gepc
䀵	hctd
双	cc
萱	apgg
烑	oiqn
醝	sgua
鈩	qynt
㪉	wgkty
湜	ijghq
馘	uthg
虏	halv
篟	twge
秏	ttfn
㺑	qtce
妵	vygg
蔆	aift
偘	wkkk
整	gkih
岯	mgig
僟	wxxt
趛	fhqd
䍋	rmtf
荶	akwn
皋	rdfj
尙	imkf
㷱	cefo
㧶	rtmt
䅯	tyvkh
趽	khynw
㸖	wqeg
䈍	tynh
梋	skeg
纪	xn
漃	iphc
罎	rmjc
檀	syl
䧗	btjt
言	yyy
箺	tdwj
篢	tamu
脯	ege
䟔	khhy
覡	awwq
挗	rgxw
䴭	swwt
䈕	tjghd
鉅	qang
奙	cdjn
荚	aguw
㷁	oceh
矋	hday
䜊	ygmj
䊫	oldd
寂	ph
菀	apqbz
㝖	pqqu
溺	ixu
兽	ulg
舰	temqd
䠧	khnj
枎	sfwy
慻	nudh
㙆	fpdcc
盡	vh
睊	hkeg
呎	knyy
胯	edfn
䑔	vgmhh
墪	ybtf
媴	vfke
㳵	itbg
簟	tsj
䓊	agkf
誁	yuah
䝦	eeti
䙼	vkhq
齟	hbeg
籶	omn
濥	iqpw
㢊	ydsk
昺	jgmwe
眶	hag
宣	pgj
畂	lqyy
巠	gvafb
动	fcl
柂	stbn
聈	bxln
搾	rpwf
羬	uddt
绎	xcf
勴	hallp
㦀	ntdp
腅	eooy
袂	pun
㠣	mdth
睭	hmfk
霿	fcbhl
辕	lfk
呏	ktah
吿	rhkf
胀	eta
娟	vke
唈	kkcn
梃	stfp
蓼	anw
簞	tkkfn
牃	nhdsc
䩐	aftn
硠	dyve
种	tkh
㮔	stgf
谖	yef
蘑	ays
蜠	jlty
蜓	jtfpn
㐪	ybwu
倐	whtor
神	pyj
衖	tawh
裠	vtke
䁥	haak
昶	ynij
偗	with
醔	tosg
䨱	fttt
椡	sgcj
㞻	mkgn
䬆	mtjje
檏	sogw
苪	agmwj
䰢	rqch
䆔	pwkhu
踛	khffn
䄄	pyld
蘽	alls
墘	ffjn
㝽	dnii
普	uo
赾	fhrkl
㨴	rfjnx
䜀	yvyhc
帜	mhkw
犔	trro
聖	bkgf
㓝	fjjh
鈦	qdyy
磋	dud
膼	emnp
汥	ifcy
匛	aqyi
峵	mpdc
㢍	yamd
熉	okmy
奸	vfh
䞹	fhrg
鼽	thlv
椼	stih
䵒	twijg
㑆	wkqn
嶏	mdsn
嬓	vryt
韆	afsp
礥	dahm
㫄	fqyb
赊	mwf
㓈	udg
㤞	npta
䗎	jsfg
莒	akkfs
竅	pwrt
㩸	rllg
仿	wyn
庿	yald
景	jy
啤	krt
渺	ihit
僷	waas
錥	qyce
鬴	gkmyu
㷛	wksot
㶻	tdho
焻	ojjg
桪	svfy
浶	iprh
䔗	apyd
稒	tldg
䒦	atpu
咧	kgq
䖝	tji
篾	tldt
粝	odd
銆	qdjg
脇	elll
喠	ktgf
㸽	trmy
㟴	mrqc
聵	bkhm
㧎	raht
憻	nylg
迪	mp
䏙	epqn
歳	hdgt
底	yqa
䄔	pyty
䇢	tdf
估	wd
䄐	bmfnn
攺	nty
睏	hlsy
釟	qwy
莊	anhf
磕	dfc
罅	rmhh
酌	sgq
荇	atfh
㶥	ofh
呛	kwb
腕	epq
猸	qtnh
洑	iwdy
帆	mhm
詇	ymdy
楾	sriy
渇	ijqx
唑	kww
䖗	hadt
鍰	qefcm
皉	rhxnr
灖	iysd
铝	qkk
苎	apgf
擫	rdjd
莫	ajd
煣	ocbs
鏆	qxfm
楩	swgq
浥	ikcn
飁	nrmj
涏	itfp
遧	ujpk
宛	pq
耭	dixt
玒	gag
垃	fug
蛔	jlk
豻	eefh
缻	rmgn
槒	syxl
䈹	tpwj
䛈	ytdyd
㖏	kjfg
儒	wfd
蚎	jjg
荞	atdj
鄯	udub
䣫	sgfc
黤	lfonm
㣁	xate
椈	sqoy
釰	qvyy
㠋	mkkn
墄	fdht
膮	effq
灭	goi
褒	ywk
㽁	dttn
㣫	ttgfs
嗋	klle
羭	udwjw
蔾	atqs
琺	gifc
霆	ftf
橀	sycl
獙	qtut
手	rt
仠	wfh
秨	tthfj
糀	oawx
迿	qjpd
㲸	inn
饕	kgner
說	ywkq
渟	iyps
茐	aqry
锏	qujgm
巼	ckxb
搄	rnggm
芀	avbu
胧	edx
嫞	vyvh
瑳	guda
䰎	dekm
护	ryn
梦	ssq
膇	ewnp
篔	tkmu
濤	ifnf
臎	enyf
㻘	gpjh
聁	bwvn
㡱	yqyi
䙃	pude
菕	awgaw
㧘	hxrj
疽	ueg
宩	poum
表	ge
罷	lcex
糞	olawh
咹	kpvg
厜	dtgfi
虑	han
糔	ocyj
䟖	khmh
沚	ihg
鐟	qfwj
䕺	aogc
挷	rdtb
䞏	mlny
靪	afsh
煭	vgqo
詥	ywgk
䔘	armg
喞	krxb
焘	dtfo
覎	hqbd
䎗	tdkn
滆	igkh
楻	srgg
藱	aurc
蒖	afhw
沛	igmhy
㞬	mafm
䴷	swwqg
瞁	hhdy
咉	kmdy
愗	cbtnc
萒	aucq
酠	sgsk
糘	opey
貺	mkqn
蚶	jaf
䆙	pwgh
棰	stg
嬈	vffq
䂞	dsu
竻	tlb
浐	iutt
㻯	ghah
羫	udpa
牺	trs
勪	tdklt
䔶	arjh
惴	nmdj
䊭	ofnf
阐	uuj
年	rh
瑬	iycy
辛	uyghh
遄	mdm
肪	eyn
臚	ehal
㞆	dndk
埽	fvp
恰	nwgk
昫	jqkgg
缟	xym
旑	ydskj
㥶	pfjn
僰	gmiw
笗	ttuu
鈬	qnyy
栊	sdx
録	qviy
䇀	pwab
懂	nat
牆	nhdk
䕢	adua
屽	mfhp
蘩	atxi
鍦	qytbc
黇	amwk
牶	udrh
蛑	jcr
暗	ju
㘻	fldy
焪	opwx
燝	ojyi
相	sh
㯠	syxh
䊇	ogeyk
㥓	ndsk
羮	ugoy
扇	ynnd
悟	ngkg
㫸	jgvhe
圷	fghyh
崣	mtvf
湩	itgfj
剋	dqjk
䴰	swwab
㳶	iebn
竨	uhjh
宰	puj
佧	whh
贠	cmu
樞	sakk
蟋	jto
幘	mhgm
每	txg
粥	xox
跈	khwe
汔	itn
韻	ujkm
㷍	owgag
攱	ufcy
旽	jgbn
紫	hxx
伳	wann
氾	ibn
钋	qhyb
峕	myjf
幐	eudhp
帽	mhj
㷧	odri
斺	ywjhy
焠	oywf
阩	btah
䍣	lflf
㲓	tfnt
焷	ortfi
畼	ljgrz
㗔	khayr
㘷	faqy
捺	rdfi
爁	oahl
廪	yyli
槓	samy
警	aqkyw
睅	hjfh
㶨	giou
舘	wfkn
烡	oawu
㛇	vyfg
甋	umdn
蚼	jqkg
熨	nfio
剾	akkjc
䑨	tetb
胶	eu
飸	kgne
覩	ftjq
茈	ahx
霖	fss
䪦	ujag
齸	hbul
罳	llnu
銒	qftf
糯	ofd
罜	lygf
䠕	khhs
夜	ywt
郇	qjb
邧	fqbh
痗	utxu
㝝	pssuy
箢	tpq
孼	btwb
髶	debf
蔢	aihv
窠	pwj
蝲	jgkjc
偊	wtky
唰	knm
趇	fhud
娔	vdqn
玑	gmn
沝	iiy
䩚	afqyu
醰	sgsj
槗	sdkk
禫	pysj
妊	vtf
濽	ifwm
㣽	vnu
攷	gnty
橼	sxxej
㻳	gatj
酃	fkk
癍	ugy
瑱	gfhw
䙅	pusv
擏	raqt
泎	ithf
弎	add
㯎	sysy
掂	ryh
寤	pnhk
锅	qkm
攍	ryny
㖑	kaah
詋	ykqn
墽	fryt
旾	gbnj
䀜	qrhf
潂	imug
空	pw
哟	kx
䐬	egmj
蜳	jybg
掿	radk
潹	isss
㵠	ipwm
氹	nii
胂	ejhh
薖	amnp
怣	rwnu
齨	hbvg
坽	fwycp
詣	yxjg
齢	hobc
㘲	fnvn
䄃	pymd
缾	rmua
席	yam
祵	pyls
襩	pufmr
㩢	ralt
㰅	sump
射	tmdfj
䤞	qdnn
貌	eerq
䗁	jdsk
䒼	amaf
䇋	uqqyu
桘	swnn
枣	gmiu
疢	uoif
廀	ypoc
秝	tty
隧	bue
澀	ivyh
裤	puy
㓫	dgajo
菅	apnn
汮	iqug
䧙	bmwn
蹁	khya
盎	mdl
䒅	teuh
籈	tsfn
疚	uqy
㾇	uhd
霫	fnrf
齚	hbtf
灊	iaqhh
兒	vqb
竝	uug
嗼	kajd
氵	iyyg
谅	yyi
桯	skgg
夡	qqfk
臷	fagf
埵	ftgfs
怖	ndm
媉	vngf
牸	trpb
㕜	khcu
諉	ytvg
澜	iugiv
嵄	mugd
慝	aadn
囕	kahq
瘆	ucde
礄	dtdk
蛨	jdjg
莋	awtff
嬟	vugt
㥲	fhwn
镍	qth
庉	ygbn
択	rnyy
鄠	ffnbk
䵆	swwe
麰	swwh
蚩	bhgj
拡	rycy
䤚	ejfg
烽	ot
邻	wycb
䎪	dijf
㾸	uymk
錧	qpnn
榡	sgxi
套	ddu
㷯	ofdh
蓔	augo
惓	nudb
䑕	vmfh
苧	apsj
栽	fas
䀠	hhg
㱚	gqeg
鞍	afp
狐	qtr
佌	whxn
宑	pfjj
訏	ygfh
葌	avvvn
讈	ydth
㪏	rtfc
㧤	rycqd
球	gfi
鐍	qcbk
㷈	odjn
錦	qrmh
䴱	swwx
銎	amyq
忙	nynn
茥	afff
䜢	ypdn
圶	dffr
夽	dfcu
㣎	rier
蜚	djdjm
臵	gcfk
貅	eew
訣	ynwy
溒	ifke
竁	pwtnm
䢖	vfhp
䋰	hwxi
䉗	trkb
叡	hpgcm
黄	amw
㚡	dskk
壯	nhdf
䧤	bogy
㭆	egsu
㘕	kaal
靀	fape
丰	dh
臰	thgx
衜	tuth
疀	vlgh
闬	ufkw
䦻	bbg
只	kw
㞧	meb
墝	fffqb
褟	pujn
咷	kiqn
㛶	vmdo
迏	dypi
櫗	salt
䓝	ablf
猖	qtjj
鞄	afqn
詒	yckg
㖷	kjgh
伞	wuh
镣	qdu
廣	yamw
菿	agcj
蓁	adwtv
淳	iyb
䗰	jxfm
埘	fjfy
阭	bcqn
靫	afcys
䁾	halt
墋	fcce
麫	swwnk
蔁	aujj
虯	jnhh
舻	teh
垊	fnanu
苭	axlb
齮	hbdk
㚼	vlg
锩	qudbr
躻	tmda
松	swc
倥	wpw
㹧	qtmde
滂	iup
翁	wcn
螄	jwnh
㓟	hcjh
铹	qap
澪	ifwc
㥸	naln
㤹	nfiyg
刴	esjh
篜	tbio
芇	amhjy
筀	tfff
罩	lhj
磞	dmee
取	bc
醿	sgyiy
墓	ajdf
裫	pujge
畫	vflg
蘀	arlf
掘	rnbm
夔	uht
庰	yuak
鄑	gogb
枦	synt
脉	eyni
䞜	fhgi
蛺	jdww
食	wyv
䰐	deal
搮	rssy
決	inwy
竓	utfnt
耺	bfcy
聰	btln
袴	pudnp
㨳	rpdk
䐒	edqq
藢	atmt
睦	hf
貝	mhnyl
峆	mwgkm
㖅	kdgti
棅	stgi
凾	bkcb
牁	nhdku
芎	axb
奣	gdje
㵁	iayq
洮	iiq
銲	qjfh
眑	hxln
夏	dht
矣	ct
䘾	pupn
稖	tukg
䐐	etoy
徂	tegg
聙	bgeg
䜈	yvjs
臸	gcff
赢	ynkyu
铁	qr
渗	icd
䙴	sdbb
鞊	affk
㥵	nley
钆	qnnz
㪢	vhcc
剕	djdjw
猘	qtrj
憀	nnwe
剁	msj
皖	rpf
鋘	qkgd
揃	ruej
聳	twwb
蹟	khgmh
跓	khyg
䂤	dwfy
㹺	qtij
鞃	afxc
械	sa
硩	rrdf
蛖	jdne
膠	enwe
鎻	qvmy
耚	dihc
椿	sdwj
擤	rth
珟	gmgq
䉅	tfuy
策	tgm
掋	ryqy
籄	takm
磘	derm
办	lw
埶	fwfyg
藀	aooo
嗱	kwgr
昕	jrh
䅳	tqbtn
萀	aham
豬	eftjg
咗	kdag
敨	ukty
膕	elag
肫	egb
晦	jtx
阵	bl
詳	yudh
蘖	awns
主	y
抩	rmfg
㼍	diry
鉵	qjy
㒭	kqkq
浉	ijgh
痐	ulkdk
揍	rdwd
凁	ugkia
矄	htgo
蜈	jkg
㼷	mdmn
躞	khoc
賦	mgah
蒕	alwl
嗾	kyt
隩	btmd
㮳	seud
㜫	vtmta
耿	bo
毷	jhtn
睥	hrt
異	la
抿	rna
讝	ykkt
塪	fevg
粋	ovfh
诵	ycehf
㖞	kkmw
嘾	ksjh
㟀	tmja
吼	kbnq
㓉	utdg
匎	qdjn
缳	xlge
珣	gqjg
㶩	opqn
臻	gcfta
秦	dwt
㻥	gusg
葓	aiaw
蘗	anks
箅	tlg
圧	dfd
錂	qfwt
蒟	auqk
町	lsh
淖	ihj
蕵	aqwe
穰	tyk
㮨	slwt
萹	aynam
抈	reg
白	rrr
脴	egik
阯	bhg
舺	telh
㭶	sayn
薘	afup
忲	ndyy
㛮	vpoc
䥂	qpfe
㕯	mwkd
䖳	jpta
䈱	tevf
肔	ebni
㫮	hxjf
抆	ryy
损	rkm
鍫	toqf
甀	tgan
阢	bgq
逴	hjpk
祐	pydki
芴	aqrr
湤	iytbs
鈓	qtfg
硉	dvfh
捠	rrgw
瘸	ulkw
䢹	anbh
姄	vnan
柒	ias
䨗	febf
䀹	hdww
㛅	vbg
善	uduk
䉸	tuyus
育	yce
躨	khut
䏝	efny
攁	rude
螎	jgkhf
貳	afmi
撞	ruj
䖿	tqtj
㹞	qtrh
虁	auht
昞	jgmw
䠸	tmdn
䜎	yool
帴	mhaad
䇖	tqtr
官	pn
㣲	tmgth
覫	upyq
忽	qrn
氚	rnkj
㖚	wfkx
嶖	mwgn
馔	qnnw
闻	ub
潵	iaet
㦼	dwva
䝥	eetf
灨	iujm
佩	wmge
濢	inyf
㽽	uddq
䥷	qthj
籿	ofy
颼	mtjc
轮	lwx
䛭	yfuf
茓	apwu
垏	fvfh
钧	qqug
㚝	dwff
窆	pwtp
絛	whti
㛊	vmsy
貁	eepw
鎗	qwyk
拎	rwyci
勑	swwl
萳	afmf
迫	rpde
拝	rdfh
睹	hft
胍	erc
坡	fhc
篻	tsfi
㞍	nvyi
殧	gqyn
䤸	qxey
糗	othd
粩	oftx
苐	axht
昦	jdjj
仈	wwy
㑦	wynd
袰	xgue
猇	qthm
洴	iuah
蟻	jugti
腱	evfp
昿	jycy
㠪	ghdz
螠	juwl
泘	ituh
誔	ytfp
㳂	iwcy
良	yv
䌋	xawk
錆	qgegs
逭	pnhp
訙	yvyyw
䂱	dukq
畵	vflb
牤	tryn
蚗	jnwyl
彸	twcy
䩩	afpbd
瀚	ifjnq
栶	sldy
瀆	iflm
啝	ktkg
媨	vusg
鬋	deujx
賣	flmu
䀧	hawy
粟	souw
咇	kntt
箶	tdef
䚍	gmhq
红	xa
㱢	gqye
陌	bdj
婨	vwga
哮	kft
嶚	mduin
泜	iqay
㕥	kwyf
奶	ve
噀	knnw
埨	fwga
䅇	stu
贃	mkkne
兾	ulaw
㨭	rync
狯	qtwce
楪	sans
㑟	wrgw
壮	ufg
隳	bdan
碅	dlty
轷	ltuhk
盵	htnn
镒	quw
艋	tebl
肦	ewvnj
醡	sgpf
䚉	dhvq
哀	yeu
龢	wgkti
鎊	qupy
憋	umin
桤	smnn
㭐	dgsu
旙	ytol
麸	gtfw
眘	duhf
拔	rdc
庽	yjmy
绒	xad
䌽	xesyf
圀	lwyv
柇	styc
碋	dmsk
棘	gmii
瑲	gwykn
攌	rlleb
抟	rfn
口	kkkk
栤	suiy
郟	dwwb
噛	khob
鼻	thl
综	xp
阜	wnnf
銍	qgcfj
㨡	rley
僊	wsdn
簑	tykey
杞	snn
峷	muji
䐧	eymk
潭	isj
㻑	gtbg
伃	wcbh
蛿	jwykq
禱	pyff
歷	dtth
感	dgkn
埜	ssffg
圆	lkmi
闽	ujil
義	ugtt
㷝	opwd
崛	mnbm
嶂	muj
要	s
敮	tfvc
䗞	gdjj
啫	kftjp
冲	ukh
鉱	qycy
㓣	wgkjd
戧	wyva
䈬	tigy
杵	stfh
淪	iwgaw
臆	euj
桾	svtk
㛰	vnaj
犮	dcue
谚	yut
耾	bdcy
纻	xpgg
㣓	hqce
帎	mhpq
鏼	qtgi
渜	idmd
沙	iit
㒤	wbbb
荦	apr
未	fii
娎	rrvf
篛	txuu
晎	jawyj
鈒	qeyys
鉤	qqkgw
妦	vdhh
礋	dlffq
遺	khgps
婊	vgey
菉	aviu
璕	gvaf
働	wtgl
摆	rlft
軃	tmdfp
簩	tool
僣	wfwj
殠	gqtd
譱	udyy
槎	suda
泉	riu
珷	ggah
猗	qtdk
绂	xdc
埒	fef
傷	wtjr
蔖	ahag
扛	rag
諤	ykknu
岂	mn
霊	ffog
㳝	iwtfq
䠒	khde
琌	gmwn
䅂	ttkg
阻	begg
纮	xdcyp
朰	snbv
槙	sfhw
倕	wtgfp
簣	tkhmc
裰	pucc
酢	sgtf
䌾	xfmfc
喎	kmnk
㩈	rpwk
贛	ujtm
㠇	myin
䥪	qjxo
偨	whxs
暦	dssj
糢	oajde
椮	scde
藤	aeu
灵	vo
篴	tepu
䝬	mygg
䇗	twcu
諚	ypgh
璅	gvjs
㵤	indw
刊	fjh
㵸	iwgac
調	ymfk
㶺	ogdk
嬕	vlff
糜	yssot
酉	sgd
蟶	jbkg
㧍	ryna
譏	yxxt
㞋	nci
倇	wpqbc
钥	qeg
萈	ahqy
樮	sgjo
爬	rhycj
疣	udnvv
㣇	xgrhk
㼭	fhkn
壏	fahl
溮	iwnh
浡	ifpb
㜨	vnih
爷	wqb
賈	smu
粴	ojfg
恷	wsnu
爎	opdi
湡	ijmy
鋳	qdtf
跽	khnn
䥁	qclf
宐	phng
货	wxm
齄	thlgw
喃	kfm
㳌	ilh
㐎	ynbc
檟	ssmyr
逢	tdh
忪	nwc
堝	fmnk
抍	rtah
涰	iccc
㣾	ncyy
懤	nfnf
劕	rrmj
㗈	kcel
噐	kkak
陷	bqv
孭	bmy
夹	guw
涖	iwug
䇃	unn
煦	jqko
啕	kqrm
忞	ynul
麹	gtqo
炃	wvou
䧖	baat
栦	syth
畇	lqug
蒘	avkr
價	wsmy
㓮	mfkj
檈	slge
拃	rthft
曍	jthf
翮	gkmnv
䟃	fhce
喫	kdhd
洆	ibig
㵮	idaf
㝾	dnda
棓	sukgl
䠡	khhg
瓀	gfdj
槹	srif
庁	ysk
㻂	guah
甶	tld
庴	yajd
礞	dap
渹	iqyg
镔	qpr
饣	qnb
痯	upnn
圻	frh
薱	aogf
㜾	bwjh
峫	mahb
㳡	ifpy
竰	udjf
汩	ijg
锌	quhj
䗇	jqoy
蟣	jxxt
嶀	mffn
䰨	rqchx
族	ytt
夆	tdhj
粹	oyw
忕	ndy
奉	dwf
泛	itp
㴗	isvg
烳	ogey
勲	tgjom
宔	pygf
纾	xcb
訾	hxy
张	xt
呣	kxgu
幉	mhas
棑	sdjd
誼	ypeg
吆	kxy
匌	qwgkg
㗧	kpwf
枋	syn
椋	syiy
䩺	afwn
䃃	dmun
䣾	sgpg
炂	owcy
薓	aivce
遭	gmap
㲕	eftn
郠	gjqb
僪	wcbk
粅	oqrt
㧂	ynld
伉	wym
䍇	rmtp
覝	fohqv
排	rdj
淫	iet
毴	tfnd
丹	myd
厏	dthf
薵	afnfs
㱣	gqev
㕞	nmhc
㜰	vxrs
㾁	usyi
湞	ihmy
狁	qtc
踞	khnd
叔	hic
忍	vynu
獏	qtadf
鍹	qpggb
竧	utmt
矯	tdtk
㱻	gqyyo
妲	vjg
煓	omdj
呷	klhh
櫘	sdhn
荪	abiu
噱	khae
檝	skbt
歸	wnnh
滄	iwyke
㧳	rwvr
塬	fdr
寱	pnhs
濻	ibkm
椽	sxe
娌	vjfg
教	ftbt
喵	kal
䄆	pytd
弴	xybgu
㷷	onnw
宗	pfi
図	luqi
陝	bdty
訆	ynhhp
枒	saht
停	wyp
硬	dgj
揧	gkir
墚	fiv
靖	uge
磿	dttd
低	wqa
㞵	myu
忆	nn
䀑	hcyy
貎	eevq
招	rvk
滽	iyvh
瑭	gyvk
㷉	nfof
燡	olffg
䊯	oyaw
因	ld
䵩	tjlo
贼	madth
㭀	etaw
䔱	arkb
㑻	wpnm
櫧	syfj
舳	temg
齆	thlc
黏	twik
叴	vkf
隁	bajv
䨘	fhqb
珵	gkgg
粉	ow
蘆	ahal
匇	qqi
鑡	qhbh
䀬	hwgg
庻	yaww
个	wh
䣪	sggh
䀿	hrrh
旹	bhgjb
㣬	tkbg
氲	rnjl
判	udjh
逡	cwt
㦒	nlyg
酼	sgyq
砋	dhg
獠	qtdie
皞	rrdfw
䁖	hovg
莇	aegl
祯	pyhmi
媵	eudv
㵩	iaas
郰	bcbhv
㴯	iexj
藂	abci
庆	yd
觊	mnmqu
櫮	sgkk
䰋	dejv
虫	jhny
嵝	mov
辤	epcu
垞	fpta
莳	ajfu
拂	rxjh
金	qqqqg
庞	ydx
缪	xnw
䒒	angf
㟍	myve
鄎	thnb
蕫	aujf
槮	scce
鐲	qlqj
怑	nufh
咠	kbf
鄨	umic
婖	vgdn
籍	tdij
妉	vpqn
貮	gami
桛	shgh
茣	akgd
堋	fee
釈	tony
㯻	gkhs
嬢	vufe
怤	wfnu
㙯	fwfc
凵	bnh
娢	vwyk
叜	pocu
犏	trya
怭	nntt
膉	euwl
氱	rnjr
陧	bjf
幕	ajdh
垲	fmn
筦	tpfq
䥶	qdth
椁	syb
䐈	efhg
韃	affp
慲	namy
㧵	rgik
伋	weyy
㧺	rijg
嫱	vfuk
䔉	attu
㘅	ktqh
讳	yfnh
琹	ggsu
䖭	udju
鐯	qafjq
瑥	gjlg
侗	wmgk
谂	ywyny
奏	dwg
癢	uude
吰	kdcy
勏	ukln
赙	mge
挼	revg
㹟	qtnw
腣	euph
狀	nhdd
鎍	qfpi
荠	ayjj
㖎	kxwj
岍	mgahj
㺲	gnfg
洠	icrh
懇	eevn
䈵	twcn
幎	mhpub
諪	yyps
膫	edui
術	tsyh
媏	vmdj
䈯	tfhw
懄	nakl
豣	eftf
舾	tesg
坊	fyn
脺	eywf
㦗	nssi
錌	qmdf
怨	qbnq
㤗	dwnu
瀛	iynyi
䖸	trnj
㳑	ilgx
拉	ru
煰	okkk
枞	sww
䨰	fiaf
哸	kevg
㱖	hywf
㐱	wer
稷	tlw
㚘	fwfw
薮	aovt
㶾	sgou
㒼	amhy
益	uwl
䧝	bbhj
㐲	wdy
㤌	nafg
㱰	gqpu
拮	rfk
刎	qrj
篚	tadd
云	fcu
鍒	qcbs
䆷	pwck
玥	geg
厒	drmk
萰	agli
㺫	gjh
㘬	fqcy
渻	iithj
锣	qlq
㣟	tfkg
璿	ghph
㠕	mbrc
攘	ryk
匣	alk
摯	fufr
䒾	ayeu
撆	umir
螪	jumk
硫	dyc
痥	uukq
噤	kssi
㢂	ywnn
秧	tmdy
尗	hiu
貽	mckg
㟆	mwxf
丽	gmyn
䭌	dewe
吧	kc
蠢	dwjj
赋	mga
槱	ssgo
衈	tlbg
巢	vjs
䴾	swwap
戰	kkja
儴	wyke
圄	lgkd
涙	iyndg
讅	yptl
肥	ec
膜	eajd
鈆	qwcy
祈	pyr
砯	dyiy
詂	ywfy
㾏	uffd
埌	fyven
㛎	vkkg
㙅	fksy
㑳	wqbt
㳐	isnn
灆	iaal
锄	qeglf
㧠	rciy
䤋	usgg
㢉	ytta
䆧	pwtv
潝	iwgn
䙆	puwdx
羦	udpq
垧	ftm
片	thg
眊	htfn
䝰	mffy
芣	agiu
戛	dha
礉	dryt
㷟	ownpx
䏏	egfh
摴	rffn
犞	trtko
馌	qnfl
孱	nbb
伂	wgmh
䉼	orh
咈	kxjh
螺	jlx
酛	sgfq
赀	hxm
桑	cccsa
乬	annba
劃	vflj
榎	sdht
硱	dlsy
䞪	fhar
倻	wbbh
粮	oyv
偰	wdhd
咜	kpxn
蔘	acce
䐲	enrg
啁	kmf
媣	vivs
豳	eem
㛻	vdff
矼	dag
蜨	jgvh
悴	nywfg
枪	swb
嫭	vhah
挍	ruqy
禸	mci
郃	wgkb
㩒	rssi
愱	nutd
䐷	ekkf
伖	wdcy
袆	pufh
砶	drg
鄋	vhcb
尪	dngd
慑	nbc
洡	idiy
妝	nhdv
鑚	qfwm
誧	ygeyy
覈	sryt
旞	ytup
橎	stol
䁛	hrqc
匀	qu
愴	nwyk
咖	klk
乥	tunbn
遜	btxp
報	rb
铫	qiq
偳	wmdj
牀	nhdsf
㬰	jwi
䠁	khcf
焩	oeeg
䜖	ysmy
凓	ussy
漕	igmj
獂	qtdi
湖	ide
邕	vkc
梓	suh
㾐	ugqj
躑	khub
熾	ouaj
䗑	jjug
咦	kgx
犡	trdy
㘃	kadn
靹	afmw
略	ltk
㛹	vwgq
绹	xqrm
弆	fcaj
溯	iub
㻗	djdy
艌	tewn
筰	twtfj
昌	jj
㝮	pbmc
笴	tskf
朲	swyd
砅	diy
謿	yfje
䙐	pughu
䑀	enku
违	fnhp
庅	ytci
䰧	rqcm
霑	fihk
㑀	wdyy
乪	nldj
筼	tkmuz
嬠	vkks
㾊	ugmi
灓	xyxi
爰	eft
㑎	wvmh
㐑	tunb
雩	ffnb
㻇	gwgg
賒	mwfi
㱨	gqph
粿	ojsyx
飱	gqwe
癓	utmto
醭	sgoyc
桐	smgk
蓀	abti
僮	wuj
环	ggi
豤	evey
溡	ijffr
慯	ntjr
䣿	sggl
訍	ycyy
噠	kfup
华	wxf
邝	ybhp
擵	rysr
沾	ihk
䟮	khwdf
㟬	mvhc
鏰	qmee
赿	fhqa
愺	najha
嫧	vgmy
呖	kdl
吔	kbn
錄	qx
伆	wqrt
扄	yntkp
㗡	awex
剦	djnj
聦	bqrn
䐫	etwhq
㵫	ibbj
䆺	pwtle
旯	jvb
朚	ynjep
袈	lky
㻔	gtgf
塟	agqf
怍	nth
鏲	qyxh
鈢	qsy
棸	bcsu
㽂	wgknj
峍	mvfh
吢	nkf
㿵	hcdd
佢	wang
魊	rqcg
䙌	pukm
殰	gqfmn
爥	onij
廅	yfcl
槞	sujna
鑟	qflm
庳	yrt
巖	mkktm
棚	see
砬	dug
郿	nhbh
㯈	sgkp
唾	ktg
㲷	rnkf
盚	fiyl
㾫	uyna
鑀	qept
㢏	ywgja
璊	gamy
䉁	tbwc
㷾	ohae
鐘	qujf
㖟	kepc
侐	wtlga
簚	tlah
庭	ytfpi
杓	sqyy
䟳	khndq
躃	khnu
桲	sfpb
㧬	amyr
耛	dick
鏒	qcce
符	twf
夃	eci
楌	sute
配	sgn
怀	ng
虰	jsh
埼	fdsk
悿	ngdn
㽻	ufcil
㯉	shah
瑅	gjghx
諄	yybg
祙	pyfi
漤	issv
䔟	atqq
䕤	akkbw
琂	gyg
抒	rcb
釆	toi
荊	agajt
姰	vqjg
䢼	awbh
䏾	edwh
㴙	itfv
竣	ucw
摼	rahf
傋	wfjf
腩	efm
藈	ahwd
篮	tjtl
苞	aqn
昴	jqt
沒	iqcy
䔷	aggn
栎	sqi
穆	tri
溫	ilwl
纽	xnf
䠴	tmduk
諎	yajg
灻	fou
搪	ryv
峱	qtnm
斳	akgr
谔	ykkn
坷	fsk
娜	vvf
缭	xdu
诱	yte
釚	qvn
鋎	qpfq
䧁	bqkg
烫	inro
緊	ahnia
黡	ddlo
䢌	gmhp
洯	dhvi
煚	jano
蝤	jus
伕	wfwy
殖	gqf
巩	amy
元	fqby
痼	uld
娂	vawy
音	ujf
瑐	guej
㥖	mywn
肵	erh
坚	jcf
勎	fwfle
蜹	jamwx
帬	vtkh
袎	puxl
䧕	bakg
哲	rrk
墡	fudk
䐟	efjf
銚	qiqnj
寬	pahy
㓞	dhvns
䵰	lfor
䈉	tuvf
嗜	kftj
蓍	aftji
嗓	kcc
恂	nqj
蛁	jvkg
処	tmvf
脩	whte
㗝	kugo
謤	ysfi
濴	iooi
芢	awffk
勄	txgl
㷇	qqdo
賜	mjqr
媥	vyna
财	mf
偵	whmy
䟑	fhwa
䘹	puyf
粚	otbn
澰	iwgwk
䢢	wyvpa
茫	aiy
僓	wkhm
锵	quqf
藔	apdi
慍	nlwl
啭	klfy
笨	tsgi
遌	kkfp
融	gkm
瓮	wcgf
鄃	wgeb
睞	hsww
蚬	jmq
懐	nyles
朸	sln
笢	tnab
炤	ovkg
哥	sks
衃	tlgi
沆	iym
矑	hhal
鈙	qhcy
䙇	pudda
鉾	qcrh
褼	pusn
㳒	idcyk
䤛	qnhh
㞓	nxjd
鉟	qgig
鉺	qbg
傎	wfhw
徼	try
聴	bfln
玕	gfh
裵	ydje
㗸	ktrh
樑	sivs
沭	isyy
䄒	pywn
谶	ywwgr
汰	idy
煠	oans
竸	ujqq
葞	axbf
勱	ajml
钱	qg
蔶	agmu
㶀	iene
勈	celn
婌	vhic
䝛	eehcp
簪	taq
劝	cl
愝	najv
㐵	wgfh
㹼	qtqo
汗	ifh
㱺	gqhl
尼	nx
㶧	omwy
柳	sqt
嵖	msjg
㙖	ftky
㢱	xciy
峟	mdef
鉮	qjhh
䬩	giwe
冸	uufhf
貆	eeggo
㼐	ynmy
娲	vkm
䑈	exrs
䚌	rdfq
见	mqb
崪	mywfq
㾃	upxv
㻺	dtty
栈	sgt
㷞	odjb
澯	ihqo
鏏	qdhv
叠	cccg
䄇	pykg
虷	jfhj
堕	bdef
䇪	tgcf
雪	fv
譖	yaqjy
坌	wvff
谣	yer
糡	oujq
俚	wjf
媰	vqbt
嘘	khag
舗	wfkyu
㿆	utye
㪼	skrh
枴	skvn
仹	wdhh
㶭	oxln
翫	nrfq
晢	rrjf
燎	odui
㛐	vgjq
䢊	bpd
伽	wlk
㟊	mebg
䤩	qpta
峒	mmgk
橸	sjjj
痝	udne
鞌	pvaf
晉	gccj
慂	icen
塕	fwcn
㜈	cbtvq
麳	swwwg
菰	abr
堾	fdwj
㥪	novg
煑	ftjo
㻏	gvoy
摅	rhanq
匬	awgj
啓	yntk
柩	saqy
慞	nujh
㽲	ugnv
㚶	vnhn
䒯	apvy
妿	lkvf
䀄	pntl
阳	bj
叨	kvn
䜏	ybde
伤	wtl
妮	vnx
杒	svyy
悒	nkc
試	yaag
厡	drii
訡	ywynd
飊	oooj
齭	hbrr
煼	oqbtr
锪	qqr
淤	iywu
㖈	ftxk
䖽	tjju
訸	yty
瞍	hvh
海	itx
秵	tldy
㳼	akgi
肾	jce
䑅	ealq
䭆	ahnet
奥	tmo
湍	imd
抙	rrh
珧	giq
宱	pwtfr
伝	wfcyb
傐	wymk
㱗	hthd
嗤	kbhj
擇	rlff
㬜	gcfj
卪	byir
僑	wtdk
琅	gyv
㥯	eavn
艏	teu
囩	lfci
帙	mhrw
䆖	pwdc
拢	rdx
鋢	qebg
钫	qyny
覟	fnhq
䗂	jham
僿	wpff
賸	eudm
搁	rut
硴	dawx
扣	rk
櫺	sfkkf
壝	fkhp
绩	xgm
枻	sann
祿	pyxi
涯	idf
菲	adj
㔷	agmwc
祝	pyk
㜓	vawk
詟	dxyf
洎	ithg
啂	kebn
趃	fhrw
菊	aqo
涩	ivy
噇	kujfd
壧	fkkt
荺	afqu
㒁	wlff
崼	mjgh
猔	qtpi
㾒	uvkd
髴	dexj
鄊	xtbb
恱	nwcq
㿸	hcjc
庱	yfwt
䘟	puxh
幽	xxm
咾	kftx
㼉	rcyqu
䑛	tdqy
乊	tur
覔	gihq
㗺	kgdd
俜	wmgn
槚	ssmy
執	fufyy
仏	wcye
㝵	jgfu
鋱	qanys
菃	aian
圼	jff
芪	aqa
跖	khdg
㺻	ggmhs
岝	mthfa
僚	wdu
䐗	eftj
汙	igfh
这	p
蚹	jwfy
銤	qoyj
䈮	tuqk
艟	teuf
䢕	dgnp
俉	wgkge
癵	uxyw
髹	dew
韅	afjo
婚	vq
脨	egki
潴	iqtj
虆	alli
㿋	ukks
些	hxf
䬀	mtjlg
焴	oyce
寽	efu
様	sugiy
刟	vkjh
磥	dlxi
㹍	trud
橂	susd
鈴	qwycq
炶	ohkg
皙	srr
恳	venu
檒	ssmj
悐	qtonm
齕	hbtn
囆	kajj
岲	mkqnv
笊	trhy
䕫	ahrt
瞅	hto
㯫	shae
渒	irtf
懹	nyke
瞀	cbthd
僙	wamw
惙	nccc
䔧	atjs
䟛	khghx
懡	nysc
䈃	tivk
㬼	dett
窔	pwuq
捛	rkkg
㲺	iann
崘	mwga
巽	nna
鬻	xoxh
葫	adef
䥚	mhhq
嬨	vuxn
禘	pyuh
䇹	tvtk
椷	sdgty
䝆	qreu
迱	pxpv
煉	ogli
拲	awrj
鉽	qaag
㦝	eern
飉	mtjie
爯	emff
敺	akkcr
艀	teeb
鐭	qtmd
㽳	ugfk
槍	swyk
誐	ytrt
䞸	fhfki
坵	frgg
凼	ibk
䎨	didn
譵	yogf
歪	gig
窩	pwmk
妁	vqy
㤪	gqbn
罰	lyjj
齤	udhb
眜	hgsy
深	ipw
妄	ynvf
梂	sfiyv
赆	mny
瘜	uthn
液	iyw
畀	lgj
踘	khqoa
黥	lfoil
椗	spgh
䬁	mtjx
狱	qtydf
数	ovt
游	iytb
鍃	qqrnl
婴	mmv
慈	uxxnf
等	tffu
郲	swwbp
䵑	twiy
莍	afiy
㹨	qtmg
㭕	sfcyb
漒	ixkj
炢	osyy
禾	ttt
捯	rgcj
㚌	qqjs
谊	ype
革	af
阬	bymn
蒛	armw
揅	dgar
筫	tmu
酚	sgw
柱	syg
鐐	qdui
聓	amyb
㭾	snbm
㬥	jbmo
㫧	jou
抲	rskg
韰	hqcg
鞙	afke
漆	isw
脾	ert
挖	rpwnq
剱	wgkyk
剞	dskj
侕	wdmj
岮	mpxn
瓧	gnyfp
蔈	asfi
埮	fooy
制	rmhj
牌	thgf
莻	aekx
䕝	atef
炏	ooy
肛	ea
八	wty
䒳	amsu
袃	avye
鄭	usgb
䭯	tjbm
䄉	pytt
䣥	sgxn
㥟	nxey
葟	argfa
㫵	jdjd
譥	ryty
抚	rfq
鐸	qlff
攊	rdth
釭	qag
兩	gmhy
䇑	urtfh
粵	tmtn
軉	tmdmm
矜	cbtnn
呻	kjh
庲	ysww
㿾	pslf
㐝	rqkn
锃	qkg
喖	ksdg
怳	nkqn
圏	ludn
铲	qut
踯	khubc
盀	hlf
跠	khgw
锍	qycq
镻	drwy
志	fn
务	tl
突	pwd
㺪	ghyy
榣	serm
䄿	tjxt
仑	wxb
彂	ogxd
摁	rld
䂙	dbh
鍮	qwgj
崖	mdff
蕂	aeul
明	je
嗥	krd
珝	gng
蓩	acbl
鈞	qqugb
嬮	djev
灷	oaj
秞	tmg
竺	tffv
邳	gigb
㞷	bhgf
穣	tufe
㞊	bmfn
嵆	tdnm
褹	pufy
揰	rtgf
䁘	herm
啲	krqy
犰	qtvn
攎	rhal
洵	iqj
籤	twwgg
鞗	whtfp
椄	suvg
㧲	rpsy
䐁	eeyyv
嶬	mugt
临	jty
叩	kbh
婓	djdv
哩	kjf
宒	ptfn
䛚	dhvy
戮	nwe
㞼	bimj
韇	affme
娕	vgki
糤	oaet
交	uq
埞	fpgh
㔹	fln
挟	rgu
鄿	akkb
奘	nhddm
禂	pymka
㧧	rycq
式	aa
㭗	slf
鐛	qjyi
摐	rtwh
硒	dsg
䒿	apef
娬	vgahr
㝳	gni
憡	ntgi
鄞	akgb
艾	aqup
䧣	bsfi
畠	rlf
筻	tgjqv
戙	mgkau
魔	ysscs
蠇	jajy
溇	iovg
浹	idww
挚	rvyr
畿	xxa
㢻	xtvgm
佄	wafg
犈	trub
痢	utj
䘃	jlff
疱	uqn
誆	yagg
䭱	tjui
䞲	fhttf
晒	jsg
楢	susg
萦	apx
眤	hnxn
踈	khgi
侑	wde
泈	ituy
燧	oue
屎	noi
煟	oleg
䞝	fhgy
晁	jiqb
傽	wujh
鏐	qnwel
哯	khqn
䁄	hfuf
㙃	frgw
㥮	nqbtz
阷	bghgg
䔝	ahxi
樶	sjbc
芥	awj
㔿	gnhk
愳	hhnu
㶪	gious
阹	bfcyk
柬	gli
許	ytfh
䛝	ynfm
㞭	dmj
螦	jgxi
棶	ssww
耹	bwyn
露	fkhk
菫	agkg
枺	sgsy
掐	rqv
窰	pwem
颫	mtjwl
笼	tdx
䓼	avde
計	yfh
鉐	qdgg
狇	qtsy
钃	qnij
災	vouy
亓	fjj
斦	rrhn
㤈	nnyg
妕	vkhh
撌	rkhm
謄	eudye
䏲	euxt
喅	kjug
伿	wkwy
酟	sghk
牠	trbn
䰭	dmjc
苶	awiuk
烙	otk
苮	awmj
悢	nyve
瘖	uujdv
仡	wtn
垹	fdtb
哂	ksg
柅	snxn
逕	gvap
伪	wyl
俄	wtr
涵	ibi
覞	hqhq
阦	boy
痚	uftb
䅲	tftj
咱	kth
堣	fjmy
籧	thap
减	udgk
㬐	jgoj
谩	yjl
䖨	jdgl
攚	rook
蚢	jymn
矝	cbtc
锊	qef
諐	wkqy
櫕	sfwm
酳	sgxe
锕	qbs
怪	nc
㳥	igaha
䎼	bviy
㭂	siy
㨄	rmfkd
堀	fnbm
草	ajj
丟	gcu
櫑	sllld
槣	spdk
戀	xyxn
媼	vlwl
岭	mwycv
蕇	akkfl
堢	fwks
祌	pykh
臽	qvf
恜	naag
殬	gqlf
㳜	iwsy
埋	fjf
銀	qvey
熩	oync
䵌	amww
镖	qsf
懭	nyaw
毦	btfn
醥	sgsi
誈	ygcf
暄	jpg
铪	qwgk
媑	vtgf
溳	ikmyf
尊	usg
秡	tdcy
覇	safe
铈	qymh
麴	swwo
罘	lgi
肍	evn
齵	hbjy
鐼	qfam
耣	diwa
鉕	qakg
鈡	qkhh
砚	dmq
銟	qmmh
㺤	qtwg
丷	uytk
臑	efdj
端	umd
薚	agqr
唿	kqrn
媜	vhmy
俼	wyce
犜	tryt
鞚	afpa
抵	rqa
柎	swfy
萘	adfi
蠣	jdaye
糫	olge
挒	rgqj
濹	ijff
咴	kdo
遡	ubtp
嫿	vvfg
霚	fcbtt
礈	duep
阈	uak
腇	etvg
粶	oviy
蘥	awga
猧	qtmks
㕌	djgf
䩴	afde
渑	ikj
姕	hxvf
呆	ks
殝	gqdt
仦	wiyy
䊳	oysd
鞟	afyb
莜	awh
若	adk
捃	rvt
撻	rfup
嚀	kpns
悹	pnhn
電	fjnb
䁞	wwwh
萢	aiqn
匟	aymv
蒆	aamv
髧	depq
䚁	tmkq
踾	khgl
偾	wfa
徆	tsgm
篭	tujn
蒸	abi
誄	ydiym
䛗	ahnyx
亍	fhk
辋	lmup
㒆	wwgn
躳	tmdkx
玵	gafg
授	rep
跱	khff
鞆	afgwd
㣺	nyi
耵	bsh
秖	tqan
樟	suj
䝣	eeis
䟊	fhhe
姆	vx
煲	wkso
孟	blf
茇	adc
䧇	byey
蝞	jnhg
䎈	njxt
峄	mcf
惁	srnu
蔓	ajl
䁂	ahnhc
仓	wbb
瑛	gam
薍	aecn
牯	trdg
硤	ddww
㬡	jfwc
䖣	jrhy
茯	awd
呐	kmw
㬌	jyji
蠉	jlge
霌	fmfk
掾	rxe
槬	sdfy
刽	wfcj
僵	wgl
僔	wusf
㾧	ujsi
䥩	qtmt
䐉	evlg
丳	kkjk
镇	qfhw
䧔	bwynd
楝	sgl
旇	ythc
訚	uyd
䐸	evfg
槌	swn
螇	jexd
梧	sgk
㮃	stvg
厤	dtti
弓	xngk
蘘	ayke
齻	hbfw
衁	yntlc
箸	tft
䐻	eduh
媞	vjgh
䠑	khdfl
帠	vmhj
㡩	xyxh
陓	bdfn
弳	xgva
䥻	qfqnh
偫	wtfft
倷	wdfi
慔	najd
䓑	aiga
錺	qaync
臅	elqj
蚿	jyxyk
雴	fuf
羘	eudh
愬	ubtn
鐵	qfag
䕋	afyk
涺	indg
䨦	fupyn
焽	jeou
埲	fdwh
䝕	ebbb
椖	syny
芉	afj
鐱	qwgw
涧	iujg
橳	seul
隟	bvjs
㽞	kklf
㭽	syqy
峻	mcw
艦	teal
珬	gdgt
刉	tnjh
俿	wham
䌺	xbga
菻	assu
恮	nwgg
諕	yham
稡	tywf
珒	gvfh
呀	ka
㯅	syrf
㐶	wnn
㴟	idjb
㘵	fdmh
櫶	spdn
儃	wylg
侴	wgnj
䃷	dyny
濏	iggt
漥	ipwfz
栮	sbg
暙	jdwj
櫋	sthy
建	vfhpo
魎	rqcy
㞱	mjf
饰	qnth
㖙	lkkx
弦	xyx
韫	fnhl
宂	pmbh
侧	wmj
蝪	jjgrl
㔽	hlkf
穚	ttdk
㽍	afgn
逖	qtop
䨩	fpyh
䘤	pusy
趶	khgff
翎	wycn
靻	afeg
鞿	afxt
凌	ufw
太	dy
狡	qtu
竇	pwfm
趵	khqy
戬	goga
㕪	kpqn
魀	rqcj
櫻	smmva
泳	iyni
單	kkjf
銭	qdxy
㤩	tknuq
它	px
婸	vjgrc
屼	mgqn
瞲	hcbk
碒	dqg
毥	tfnjq
慜	txgn
稙	tfhgv
檤	sutp
㣷	tpns
簲	terf
壪	fxyx
娧	vukqx
㑍	wdiy
齐	yjj
䘘	tgxh
䬭	kvwe
貋	eejf
粌	oxhh
厍	dlk
刘	yj
勋	kml
懱	nalt
歶	hxjy
渱	ijag
瀽	ipfh
跷	khaq
甌	akknc
蠹	gkhj
㻒	glty
漢	iakw
撲	rogy
嶶	mtmt
㐖	fknn
䙿	fihq
杌	sgqn
嘊	kmdf
躚	khsp
䨙	fitfe
楤	sqrn
撿	rwgw
蔚	anf
嶗	mool
䖬	jlh
凕	upju
還	lgkp
虭	jvn
妩	vfq
庹	yany
瑽	gtwh
䗈	jynh
尛	iiiuk
煂	oafh
楉	sadk
㡚	mhffi
貸	wamu
诀	ynwym
篋	tadwn
鍙	iawq
痤	uww
䢋	gjpk
烔	omgki
䉚	tlpn
悮	nkgd
㝢	ptky
霜	fs
錳	qblg
坿	fwfy
潃	itte
䕆	aswj
毱	tfnoa
犿	qtyh
䄀	pyat
恦	ntmk
尰	dntf
䈞	tyjf
嚤	kysr
㞩	mmyu
狤	qtfk
簧	tamw
簙	tfgf
廍	yukb
髢	debb
娼	vjj
䝻	mndgd
攭	rxej
慉	nyxl
㴑	iyut
茛	ave
匝	amh
儝	woos
衚	tdeh
捐	rke
镆	qajd
遫	gkipr
辆	lgm
豩	eey
卑	rtfj
䂝	datr
㟞	maatn
㜂	fffv
䣝	nftb
熖	oevg
椾	suej
歩	hitr
姵	vmgh
㝁	qjbf
岒	mwyn
麱	swwy
墑	fumd
武	gah
㣿	nqyy
蚡	jwvnf
䕄	abil
脘	epf
䖕	hamg
㔴	alaw
垪	fuah
谫	yue
叐	tdcu
彬	sse
抹	rgs
葜	adhd
挋	rahh
㬑	jybb
鉃	qtdy
䉪	tllls
賿	mnwe
袏	puda
䣬	sgat
㧌	rtfn
蜧	jynd
绞	xuq
㫣	jjnb
藉	adi
滊	irno
呈	kg
㜑	igev
㼶	wgenj
圎	lcmi
䇩	tjxr
幵	ftfhd
踱	khyc
缩	xpw
埾	bcff
㜗	vcce
荘	auff
悯	nuy
黲	lfoe
惀	nwga
㵘	iiii
䝅	efgt
漪	iqtk
孂	vtvl
㟭	mnaj
鑾	xyxq
淭	iyns
莮	allb
䗦	jtdp
踊	khc
邗	fbh
㽷	uiiv
䩑	afxn
恥	bny
踌	khdf
筟	tebf
㖲	vkkx
趌	fhfkl
䜂	yrdf
䁚	hkmy
讃	yfwm
踐	khaae
銯	qxiy
棤	sajg
詼	ydoy
㠴	mhvy
㽊	oyon
瓹	kegn
枵	skg
䃕	oopd
䂌	cbtf
邽	ffbh
裗	puyqw
竂	pwdi
廦	ynku
㥨	vffne
喱	kdjf
㲦	fjwn
䏜	eeyy
涑	igki
㡕	mhad
谏	ygl
眆	hyn
耩	diff
點	lfok
岘	mmqn
掣	rmhr
䠊	khdd
馟	tjeb
䘌	aadj
禍	pymk
偍	wjgh
溂	igkj
粡	omgk
㙚	fugh
哤	kdne
䅰	tldn
祗	pyqye
缺	rmn
䴺	swwkf
敆	wgkc
貘	eea
剽	sfij
㦔	jedn
吋	kfy
欙	slli
㛞	vgah
杆	sfh
罿	lujf
荽	aev
藚	aflmo
妇	vv
瘍	ujgr
䵙	twiq
㢧	xgdm
唽	ksrh
㝌	pqyu
憅	tgjnn
䤬	qiit
暞	jths
鍴	qmdj
鬳	hagh
鋌	qtfpd
舑	tdmf
潌	ipwf
娮	vyg
臟	eadtx
衿	puwn
䗏	jpoc
㣈	xgrh
悾	npwa
哻	kjfh
绫	xfw
峁	mqt
䂘	dcyy
搂	ro
魃	rqcct
郬	gebh
燑	oujf
䎢	ditnz
䘏	tlbhp
递	uxhp
娀	vadt
冑	mefz
窞	pwqv
䎕	oopna
瑜	gwg
懆	nkks
䛳	ydjn
珞	gtk
祎	pyfh
䆀	tlfo
彽	tqayj
师	jgm
铡	qmj
鋍	qfpb
劇	haej
戟	fja
㙡	ftwh
炷	oyg
同	m
䄨	tgfh
荵	avyn
谀	yvwya
䒁	tenr
㾄	umdd
蝳	jgxu
冱	ugx
誢	yhqn
㛝	vmy
㚙	lkdu
琘	gqaj
屡	no
唲	kvqn
箨	trch
聝	bakgo
嗐	kpdk
鐋	qijr
络	xtk
饹	qntkq
三	dg
䒗	atnb
㨹	rdhv
噋	kybt
敾	udut
䊩	otol
㕆	dddc
覲	akgqd
㩟	rpfs
岎	mwvn
䊔	oamd
㮦	sfpi
邵	vkb
龙	dx
懳	ndhn
旡	aqvx
孳	uxxb
走	fhu
悏	ndwwn
皏	ruah
巹	bign
榟	spuh
籘	teuiw
靲	afwni
皡	rrif
狒	qtx
畖	lrcy
賢	ahnmp
蜥	jsrh
貏	eerf
眛	hfiyy
謼	yhah
佶	wfkg
妠	vmwy
凬	mgjd
苸	atuh
椧	swgbc
硐	dmg
䙔	puak
孎	vnij
䏔	enfg
阊	ujjd
沩	iyl
喿	kkksr
䖵	jjy
腞	exey
挘	ritl
嗳	kep
珛	gdeg
䣺	sgkeg
暼	umijg
䜆	yssy
佐	wda
銻	quxt
諛	yvwy
乑	tii
䵫	pqbow
玴	gann
䒻	amnb
匞	aad
饤	qnsh
饨	qngn
息	thn
章	ujj
尥	dnq
淽	iahg
㖰	kxmk
棵	sjs
誤	ykgd
媀	vjmy
组	xeg
趪	fhaw
詝	ypsh
戔	aar
憰	ncbk
㹢	qtlk
鐔	qsjh
拆	rry
嶮	mwgw
嫜	vujh
挃	rgcf
䴲	swws
誑	yqtg
魍	rqcn
鈸	qdcyx
柄	sgm
蜔	jqlg
㹑	tram
幑	tmtt
尘	iffs
蠡	xej
囷	lti
聜	bpwa
趁	fhwe
檥	sugtc
䴳	swwwh
晋	gogj
㐯	yktj
熳	ojl
磶	dvqo
扮	rwv
蹆	khvpw
做	wdt
艿	aeb
湴	iuog
齘	hbwj
辂	ltkgn
䐰	ewhe
泹	ijggu
磖	dnrg
仟	wtfhx
糮	oahlb
僅	wakg
鋺	qpqb
各	tk
播	rtolg
柏	srg
域	fakgk
珤	grmh
坆	ftyz
喸	gehx
铟	qldya
阁	utk
蛅	jhkg
䙕	puthw
亗	mffg
虜	hallu
㝔	puquv
胖	euf
禨	pyxt
梖	smy
袗	puwe
䞃	mgct
转	lfn
䑵	teje
業	oguw
䂜	ddhh
䨒	fnf
膄	evhc
鞧	afug
邜	qbhp
㗟	iygx
恐	amyn
䑪	tewkp
霱	fcbk
琊	gahb
極	sbkgm
呹	krwy
嵬	mrq
舸	tes
䨡	fbib
攥	rthi
妴	qbvf
議	yugt
婔	vdjd
裯	pumk
蒧	adht
搥	rwnp
屫	nnhk
樾	sfht
昝	thj
迋	gpd
显	jo
䆠	pwah
舄	vqo
鉧	qxgu
㶁	iefm
䀎	hgnn
橠	syqe
䂸	dakg
叮	ksh
寁	pgvh
鋣	qahbm
卾	kkfb
齷	hbnf
也	bn
揎	rpg
娙	vgva
磩	ddht
羙	ugou
潬	ikkf
㗑	krdf
挞	rdp
苉	aaqb
瓑	gdth
煳	odegd
瞫	hsjh
鈧	qymna
㿐	ufhq
厝	daj
茖	atkfg
橗	saje
茦	agmik
䴬	swwaj
亨	ybj
䢍	ypv
蚦	jmfg
鑬	qahq
遾	tawp
皂	rab
嵎	mjmy
牱	trsk
袐	punt
匑	qtmx
抸	rtpy
蠑	joos
烋	wsou
抾	rfcy
䩿	affm
俔	whqn
奍	udjj
尢	dnv
缆	xjt
卲	vkbh
祘	fifi
諷	ymtj
㾈	uwfi
㙒	lcbf
唥	kuwc
掴	rlgy
垘	fwdy
瑂	gnhg
篖	tyvk
琷	gudn
䕩	asdi
䒱	abig
哦	ktr
憞	nybt
㠭	aaaa
勰	llln
苤	agi
月	eee
岙	tdm
㟣	mswc
蠋	jlqj
福	pyg
䬸	wyvei
淔	ifhg
屩	nttk
奇	dskf
嚴	kkdt
嵣	myvk
硔	dawy
挺	rtfp
鋾	qqrm
疥	uwj
婘	vudb
蚤	cyj
㤔	nwfy
儑	wjxo
創	wyvjw
劰	rlnl
恛	nlkg
漭	iada
嵶	mxuu
詴	ydeg
犳	qtqy
靯	affg
㣀	xfhw
窏	pwif
䈐	tndo
坼	fry
䗀	jfwt
嵡	mwcn
䍾	gang
氳	rnll
效	uqt
䍅	rmwc
包	qn
咢	kkfn
装	ufy
惪	fhnu
䟪	khtp
懖	qtdnn
惶	nrgg
崊	mssy
靛	gep
伥	wta
䝩	mwet
㠸	mhfw
䂵	damy
楟	syps
㸺	iith
㢥	mgka
傅	wge
㳱	ibjg
濛	iape
眖	hkqn
䁍	hdgtn
韯	fadg
嘮	kool
垠	fve
葳	adg
孷	fitb
䢘	pfpi
䘍	ajmji
甫	geh
籚	thal
羏	udet
㣂	xgkh
愾	nrno
橦	sujf
㳟	awiu
鑉	qafl
㹁	tryi
丌	gjk
焆	okeg
慰	nfi
昧	jfi
䎅	rngd
氕	rntr
刜	xjjh
銊	qdgtk
沗	gdiu
勭	ujfl
钝	qgbn
䆟	pwwk
鋵	qtmn
䩝	afry
仨	wdg
誶	yywf
订	ys
砀	dnr
溞	icyj
疂	lipg
究	pwv
坖	fqff
皴	cwtc
栓	swg
烈	gqjo
楺	scbse
茲	axxu
逽	adkp
吂	ynkf
摏	rdwv
偟	wrgg
㙹	falq
侠	wgu
褨	puua
乞	tnb
伸	wjh
瞐	hhhfn
衱	puey
㷔	oehj
嚝	kyaw
簻	tmnp
荴	arfw
䓬	ahjj
嫒	vepc
潶	ilfo
末	gs
标	sfi
墉	fyvh
嬴	ynkyr
嘽	kkkf
獔	qtrf
齁	thlkx
躄	nkuhn
罒	lhngl
銄	qtmk
彴	tqyyy
缗	xna
物	tr
蚒	jmyg
鈗	qcqn
壜	fjfc
䂺	djsy
喇	kgk
㭢	sgaj
䏋	vinn
㴡	itjg
虬	jnn
尽	nyu
䝼	mgegb
韬	fnhv
嘑	khah
饶	qna
脿	egey
尷	dnal
黈	amwg
荩	anyu
䁀	hrrj
㕻	yikf
䛒	agny
趒	fhiq
墖	fwgl
㹉	trdi
髽	dewf
桢	shm
蚫	jqnn
哽	kgj
屹	mtnn
渘	icbs
鞏	amyf
瘐	uvw
帯	gkgh
䞆	mimy
爱	ep
㚍	qqkm
䩷	afuyg
㚴	vdmh
䍃	ermj
鞢	afas
竑	udcyy
䇄	utnn
㝂	brrh
蘯	aijl
㯟	ssvi
麲	swwq
寄	pds
趣	fhb
㬺	eudhk
搶	rwykk
䟦	khtc
樖	wgkk
戴	falw
嵐	mmtj
籉	tfkf
㴤	isyg
钸	qdmh
毬	tfny
柪	sxln
䁮	haqj
邓	cb
揻	rdgt
哎	kaq
巚	mhadp
旘	yuajc
遍	ynm
㠷	mhey
阥	biy
箂	tswwi
儮	wdth
快	nnw
掸	rujf
栅	smm
䀦	hdg
蛐	jma
嬶	vthj
嚺	klup
帀	gmhk
扐	rlnj
㓢	tkjh
遶	fffp
修	wht
鐶	qlgei
超	fhv
蚓	jxh
梬	smgn
岸	mdfj
宕	pdf
蘧	aha
㵋	ilmy
幈	mhna
崆	mpw
氉	kkkn
琄	gkeg
䆯	pwcv
䚾	ytfg
耱	diyu
䵐	amwfm
巶	vknn
㜘	vhag
揫	torj
捥	rpqb
㠲	mhxn
陻	bsfg
柕	scbtk
膒	eakk
溅	imgtf
㙥	fuke
瀸	iwwg
访	yynd
峀	mmf
澲	iogw
樋	scep
銕	qgxw
㩧	rjai
䃻	dfae
矞	cbtk
慬	nakgj
噚	kvaf
迆	bpv
聡	bwcne
芲	awxb
㿽	wgnl
蕚	akknw
皔	rjfh
炖	ogbn
䛘	ywtf
戸	gnr
㡑	tomh
䍒	lsu
䥵	qjfq
钿	qlgg
䍚	lyve
桎	sgcf
㦍	nkkt
䅐	thqn
勮	hael
扊	ynoo
羰	udm
㐬	ycqb
廓	yyb
煡	ovfpd
立	uu
悝	njfg
萫	atjf
槢	snrg
澻	iuep
枠	svfh
䞞	fhxj
㻿	glqj
喍	khxsm
旳	jqyy
攕	rwwg
瑟	ggn
䞇	fwfmr
㼖	rcyjs
氡	rntu
䈂	tuaj
秅	ttan
䎀	nanty
㷬	oajd
㾘	ugjq
嗵	kce
袩	puhk
錑	qynd
隘	buw
泅	ilw
姣	vuq
扥	rtan
牙	ah
㡻	yqtb
薞	agqe
瘿	umm
秥	thkg
㒴	tybm
搷	rfhw
鉹	qqqy
桨	uqs
兙	dqfk
墀	fni
䊃	omgh
貲	hxmu
遃	utep
㸶	trld
㷒	ojmy
躊	khffo
媙	vdgtl
礝	dfdj
垳	ftfh
丶	yyl
拠	rtmn
摱	rjlc
鑫	qqq
缜	xfh
凢	tmv
蛉	jwycv
厱	dwgwa
㚧	vyt
吕	kk
哐	kagg
嶞	bdam
愎	ntjt
㫏	ytsv
㺳	ghcy
夳	dffg
大	dd
虚	hao
減	idgtw
㓹	dooj
䉀	tyao
䟩	khfct
偔	wkkn
乒	rgt
秪	tqay
杜	sfg
塌	fjn
睘	lgke
嵲	mths
募	ajdl
妨	vy
桇	vksu
蹄	khuh
䕇	ayrc
锗	qft
贷	wam
鎈	quda
㚿	vqnn
墜	buef
玅	yxit
撓	rffqz
崿	mkkna
䂗	dxn
䙲	sdux
烝	bigo
䆻	pwnt
穑	tfuk
猍	qtsw
还	gip
䃌	dsfg
泫	iyx
㽜	qblf
鈃	qgah
渍	igm
旣	rxaq
珻	gtxu
㙻	fyjf
束	gki
䬃	mtju
膎	eexd
媦	vleg
㱹	gqdhj
敤	jshc
䥦	qdap
拴	rwg
䏼	eaat
庙	ymd
礠	duxn
姦	vvvf
窊	pwryv
徢	tgvho
曊	jxjm
㞕	nwed
旪	jfh
礌	dflg
瘅	uujf
唼	kuv
椃	sham
磟	dnwe
婂	vrmh
燤	oajy
淉	ijsy
恘	nwsy
黆	amwq
婶	vpj
䎒	naat
覾	ptoq
聢	bpgh
韩	fjfhf
㔍	thaj
藜	atq
椀	spqb
㥤	cbtn
菵	amun
䐺	esjhp
嗈	kvkc
鎏	iycqr
蒞	aiwu
谴	ykhp
䙘	pudt
琓	gpfq
䞗	fhft
灸	qyo
匹	aqva
邲	ntbh
孿	xyxb
㵹	imad
䒠	adhj
黓	lfoa
程	tkgg
䀷	hfcl
遢	jnp
蓤	auft
㗘	kgef
獐	qtuj
惮	nuj
槊	ubts
湲	iefc
戩	gcca
所	rn
冶	uck
棇	swcnw
酵	sgfb
焵	omum
睾	tlff
邮	mb
剤	yjfj
银	qve
擂	rfl
䆼	pwmp
宋	psu
岿	mjv
泇	ilkg
䔈	aamu
诃	yske
缸	rma
媒	vaf
陘	bgva
壸	fpggw
薄	aig
㚏	dajp
斿	ytbg
䛃	yfqn
㘟	lak
俍	wyve
尤	dnvm
碹	dpgg
绺	xth
蔥	atln
笰	txjj
䄩	tay
㑶	wrno
臥	ahnw
苖	amfh
廂	yshd
耞	dilk
剧	ndj
櫎	syaw
婕	vgv
冓	fjgfu
迊	gmhpu
垒	cccfh
膀	eup
鄌	yvhb
挂	rffg
艞	tetq
淴	iqrn
罕	pwf
哬	kwsk
萄	aqr
慴	nnrg
鬏	detoy
内	mw
䁊	hcyh
楞	sl
韈	afat
㩾	tgac
唟	fckx
孨	bbbf
䙝	yfue
偻	wov
鞼	afkm
楮	sftji
佂	wghg
㲰	pnln
疃	luj
犼	qtbnc
㞲	mkhh
垥	fwgk
臗	epay
瓳	dgnnb
抭	rpmn
敦	ybt
商	um
㐾	wfqn
罡	lgh
嶆	mgmj
宾	pr
䝞	eehm
浙	irr
阎	uqvd
鑩	qgkk
㥅	nepc
蹇	pfjhg
湺	iwks
髤	desu
鑐	qfdj
琀	gwyk
䉣	tvqo
炨	opxn
䊈	otxup
屌	nkmh
㳁	idwy
抢	rwb
蘷	gjgt
烩	owf
拶	rvq
臱	thpy
撾	rmnp
枸	sqk
㚒	dtyy
剀	mnj
斁	lfut
䗩	jdht
蝟	jleg
曢	jpdi
籹	ovg
姭	lllv
藬	abkm
㧇	rmgg
誀	ybg
嘲	kfj
䇤	tgmw
黝	lfol
鉈	qpxn
忤	ntfh
䶕	hbcn
愦	nkhm
遆	upmp
岾	mhkgm
茽	awkh
捲	rudb
婑	vtvg
眎	hfiy
抺	rfiyu
萲	aefc
但	wjg
忦	nwjh
婥	vhjh
厧	dfhwt
䣹	sgwa
穬	tyawa
瓟	rcyn
狖	qtpwp
冭	duu
堓	fmdf
溪	iex
暅	jngg
镐	qym
沠	irhy
㔑	awnv
鞰	afjl
蠝	jlll
棎	spws
谛	yuph
遇	jm
蛶	jefy
鄸	alpb
炫	oyx
埸	fjq
渀	idfa
烸	otxu
忱	np
愭	nftj
泒	ircyw
㥉	nukg
㧟	rian
褴	pujl
䁫	hlfo
啌	kpwa
堰	fajv
岃	mvyu
䥊	qgmy
靸	afey
桟	sdny
戓	akd
㠹	mhwj
㯩	cccws
肩	yned
擿	rump
泊	ir
斮	ajrh
奠	usgd
雫	fghu
睆	hpfq
唠	kap
玻	ghc
炞	oyhy
肮	eym
墇	fujh
揪	rto
匁	qqij
㨷	rakgz
蔋	aihc
拀	rkqn
讘	ybbb
棱	sfw
伩	wyy
迍	gbnp
癊	ubwc
青	gef
馒	qnjc
李	sb
焨	ojeg
皪	rxrso
㤍	agnn
䟇	fhxt
妒	vynt
夿	dcb
䁝	oophv
譞	ylge
琍	gtjh
媸	vbhu
鈷	qdgs
莣	aynn
昛	jangb
圛	llff
㧛	jtyr
䆞	pwjxi
稄	tcwt
㼬	fufnt
咺	kgjg
酓	wyng
镯	qlqjq
岄	meg
淞	iswc
荂	adfn
㫍	ytwt
狮	qtjh
敢	nb
瘭	usf
合	wgk
䚓	sjhq
栰	swat
映	jmd
䬋	mtjtb
㟛	mraf
㳍	idmh
汨	ijga
㷘	ocks
襖	putd
诳	yqt
窐	pwff
嗯	kldn
璼	gahl
霨	fnfff
锳	qamdi
䘬	puad
笪	tjgf
㛪	vdjn
䙀	puee
僦	wyi
勤	akgl
痌	umgk
嚋	kfnf
霰	fae
泠	iwyc
甮	qrej
剒	ajjh
斐	djdyg
懫	nrrm
栌	shnt
抽	rm
燀	okkf
哛	kxwv
詓	yfcy
椐	snd
峺	mgjq
葺	akb
㹭	qtjx
薬	aris
赹	fhqu
袒	pujgd
䰠	rqchm
揀	rgli
鈭	hxqf
䓫	adsk
皌	rgsy
䞭	fhct
鏴	qkhk
弲	xkegb
躇	khajp
糋	ouejd
叞	nfic
倞	wyiy
跇	khan
汁	ifhp
滴	ium
屝	ndjdj
誃	yqqyy
㳀	iat
㱳	ajdq
釖	qvni
真	fhw
迚	khpk
臯	thif
崂	map
哴	kyve
徽	tmgtr
釘	qsh
跅	khry
栯	sdeg
㪋	jfhc
黊	amwfo
㡐	mhujy
崭	ml
苽	arcyz
又	ccc
粽	opfi
俅	wfiya
廾	agt
憯	naqj
悅	nwkq
舱	tew
窭	pwo
杮	sgmh
慌	nay
㡸	ythf
亩	ylf
㻎	dggd
堼	ffffk
鋃	qyve
䑖	vgvh
腘	elgy
羿	naj
愋	nefc
屆	nfbk
摩	yssr
寒	pfj
狸	qtjfx
䰂	dees
辇	fwflm
椯	smdj
䅖	tdjn
觐	akgq
便	wgj
憊	watn
袪	pufct
鈯	qbmhx
蒺	aut
媄	vugd
䓴	admd
稟	ylkt
墙	ffuk
幏	mhpe
故	dty
鼼	thlh
賄	mdeg
攲	dskca
佃	wl
郚	gkbh
㕢	hpgch
唵	kdjn
琗	gywf
䓏	agik
烟	ol
翞	nyiye
㓡	rmjh
㲞	ywwn
仍	we
庀	yxv
㵺	itrf
㩎	rjed
㾔	ukkdb
棺	spn
㾴	usjg
偑	wmtj
煛	hhou
疬	udl
弅	wvaj
粬	omag
芻	qbtt
砩	dxj
馐	qnuf
跎	khpx
㾨	udsk
颺	mtjr
奧	tmtd
眢	qbhf
溲	ivh
池	ib
䒓	agnb
邌	tqtp
霏	fdjd
垩	gogf
宨	piqb
纯	xgb
㼀	gfup
滤	iha
竌	umn
蚑	jfcy
僒	wpwks
㻀	gjqy
䘭	pugfh
舢	temhj
窨	pwujs
釣	qqyy
禔	pyjh
妛	bhgv
䄗	pyjg
櫫	efts
馑	qnag
儓	wfkfu
瑗	gefc
督	hich
僗	wool
譂	ykkf
擀	rfjn
垾	fjfh
扂	ynhk
㧆	rmhhe
謖	ylwt
槶	slag
㰉	sgct
䋕	wtfi
凎	uqg
暾	jybe
鍣	qavk
䆿	pwns
湳	ifmf
䙯	pudh
㨉	rnaj
波	ihc
跻	khyj
䝤	eedik
蟃	jjlc
辌	lyiy
詖	yhcy
蛎	jdd
薽	asfn
濅	ipvc
㖄	kyth
䜓	yaas
䟯	khtdc
㕧	kntw
㐿	wrhy
扒	rwy
㽃	tolnx
烅	otlg
暱	jaak
錻	qgahm
哋	kfbn
糚	oanf
晏	jpv
瑃	gdwj
固	ldd
桶	sce
筧	thqb
䞽	fhfi
裿	pudk
䤑	sgaw
㝕	pncu
䒈	tefm
轲	lsk
夼	dkj
瀘	ihal
㿅	uthh
㴊	iubj
并	ua
懓	nept
抃	ryhy
稸	tyxl
疸	ujg
锚	qal
叾	bkf
簗	tivs
箘	tltu
肆	dv
狲	qtbi
炚	joy
罌	mmrm
譳	yfdj
㴰	icex
搳	rpdkv
胣	etbn
嚈	kdjd
簋	tvel
㮛	sjgh
㨰	ruce
粫	odmjh
趥	fhug
勯	ylkl
丫	uhku
珌	gntt
潸	isse
扌	rgh
啳	kudb
碌	dvi
碢	dmnk
蟇	ajdj
舔	tdgnm
椊	sywf
㠫	amyw
䶍	gcfjr
㘔	kpfmd
樫	sahf
㤝	nycq
䧃	blg
娨	vjfh
姃	vghg
貦	mfqn
㡌	mhje
㫶	jvph
隊	buey
縈	oopi
培	fuk
䖐	rhamv
㻝	ggkj
齬	hbgk
䎩	divl
䢽	awkc
跀	kheg
箮	tpgg
䰮	rqctx
挌	rtkg
琜	gsww
将	uqf
罞	lcbt
墅	jfcf
湈	iafs
䎜	ftxx
槛	sjt
酖	sgpq
澓	ittt
䦷	uwwf
杬	sfqn
㧴	rtrtw
瑩	oopy
羳	udtl
瑫	gevg
䖜	hamjh
㤕	nbmh
徸	tujfb
贎	majy
虿	dnju
㳖	iyey
针	qf
铐	qftnj
䢡	ansp
罈	rmsj
惌	pqbn
摺	rnrg
眻	hudh
䥭	fiyq
调	ymf
䚒	ujfq
据	rndg
偬	wqrn
瑒	gjgr
罢	lfc
㵵	ibci
赳	fhnh
蹈	khev
䝑	eujf
欖	sahqi
詏	yxln
㯬	ssvp
樯	sfu
猰	qtddo
阝	bnhi
窺	pwfq
㞎	ncv
㓽	mpfj
魗	fnac
歼	gqt
斧	wqr
撼	rdgn
矚	hnij
尀	akfy
镼	dnbm
胈	edcy
芠	ayu
䈎	tans
縢	eudi
嶳	meffr
詪	yvey
訪	yyn
䓌	afnu
蟙	juaj
䀐	het
债	wgmyf
罻	lnff
搒	rupy
䇛	thfa
哄	kaw
茿	aamy
蠯	yrtj
㥫	nyjgd
幷	tftfn
㴵	intl
㨫	rjtl
䢎	gapk
杪	sit
帧	mhhmh
戨	sksa
垇	fmmg
剠	yijh
㞒	nthd
耳	bgh
移	tqq
京	yiu
㡺	yjgd
㷵	olfo
䄅	udfi
蛵	jgva
㺴	gdy
憇	tdan
裂	gqje
蕆	admt
嚂	kahl
蠻	xyxj
媳	vthn
扩	ry
豽	eemw
镨	quo
崌	mndg
粖	ogsyl
褃	puhe
䄊	pyfn
疇	lfnf
芧	acbj
衷	ykhe
廸	mpd
雺	fcbt
㗅	kdegt
繠	nnni
㹴	qtgq
嫂	vvh
濠	iyp
䬎	mtjg
㙸	fwoy
䔔	aujq
釙	qhy
徚	tgli
㬤	jjxor
䅤	ttfv
乱	tdn
㗄	klyn
嗫	kbc
㠥	mllf
㜻	vxyn
囫	lqr
䅍	ttfpn
㗥	kybb
䡀	tmdg
䊬	tjso
塐	fgxi
勛	kmln
羥	udga
蟥	jam
齦	hbve
锎	qugax
㚥	vgfh
嶯	mkbt
袱	puwda
蕎	atdka
橝	ssjh
䟟	rykh
㻶	gtvh
堞	fan
慪	nakk
焹	omun
畟	lwtu
谓	yle
橯	sool
誒	yctd
熒	oopo
屮	bhk
鎑	qfcl
䅭	tupy
㫚	qrjfl
殆	gqc
鎚	qwnp
䄯	tgah
苕	avkf
匒	qawk
䘚	yefj
䎍	ngeyi
荔	all
上	h
炜	ofn
髦	detn
泄	iannd
孝	ftb
斋	ydm
蓊	awc
鈼	qthf
墂	fsfi
唀	kten
袬	ycke
垫	rvyf
瑸	gprw
䯼	deqo
䏌	wef
㟟	mawb
睪	lfuf
圱	tdfg
䗓	jqrn
铙	qati
愪	nkmy
朖	eyve
䏫	ewsy
睋	htrt
㣛	twgkd
鞎	afve
㶞	ijye
䘔	tlpk
䈽	takgw
㤄	ngmh
握	rng
師	wnnhy
箑	tgvh
翀	nkhh
㞯	nmj
谉	ypjh
祷	pyd
䩜	afmg
憟	nsoy
纩	xyt
谤	yup
䁁	hyiy
碻	dymk
侇	wgxw
玉	gy
撏	rvaf
鎶	qskk
纹	xyy
㢣	aqka
汴	iyh
昸	jtuy
缇	xjg
悡	tjnu
檪	sris
竒	ukhj
嗌	kuw
䤠	qhgs
使	wgkq
倢	wgvh
钾	qlh
坜	fdl
馧	tjjl
䖅	afkw
炭	mdo
衭	pufwt
豚	eeya
桦	swx
碈	dqaj
唊	kdww
㟑	mfpb
笂	tvyu
啨	kgeg
匵	aflm
莙	avtk
捚	rjfg
䧫	bype
㳔	icfy
籽	ob
恝	dhvng
㔻	gifj
語	ygkg
㢨	xfhh
瘣	urqc
㰓	sahm
渫	iansn
䵤	galo
弟	uxh
匽	ajvd
澶	iylg
芏	aff
涅	ijfg
㷣	ough
详	yud
伈	wnyr
㳛	ivwy
蹙	dhih
犠	trutk
擣	rfnf
鋸	qndg
䋤	gxiy
妘	vfcy
䞤	fhqk
芽	aah
醛	sgag
牖	thgy
㳿	iycs
葬	agq
㴝	tjwi
㠳	tymhm
恭	awnur
㿡	riqb
毲	cccn
绽	xpg
䢫	bdapp
豶	efamh
涳	ipwa
襡	pulj
䒣	amff
澼	inku
婈	vfwt
㘦	flnf
遚	vhcp
鋛	qkkh
䈘	tuxx
圅	cluf
櫱	btws
㴱	ipwu
鏞	qyvhe
㲯	ahnnx
㐤	vfhw
地	f
䂼	dwynq
辒	ljlgc
憸	nwgw
暪	jamy
婳	vglb
裹	yjse
㭣	sukg
弽	xans
洘	iftn
麩	swwwf
钟	qkhhv
䢟	ytpi
流	iyc
豵	etwh
䩗	afegw
矌	hyaw
䀲	htxu
誩	yyg
幰	mhpn
齾	hagb
嶵	mldd
㢁	yqqi
蚸	jryy
䂖	dykf
䕎	ahgl
镈	qgef
晗	jwyk
烾	ooff
霠	fuwn
藘	ahan
㰁	sddd
蘬	awnh
诩	yngn
薶	aeefv
荍	anht
嬲	llvo
㳘	iycq
遽	hae
刐	myjh
見	hqb
沎	iwxn
拿	wgkrr
鼾	thlf
柶	slg
㽛	lqkg
詮	ywgg
堜	fgli
䇼	tkcb
蓸	agmj
陦	bdtf
杅	sgfh
啜	kccc
䇙	txhj
筩	tcej
决	un
䏣	eeggy
䑬	teiq
䃽	pyfcq
䛋	ydnt
奰	llld
㧭	abrj
烿	omye
忚	nbn
暥	jjpv
䵢	lfoi
汶	iyy
伲	wnx
粇	oymn
籖	tfag
瓨	agnna
踜	khft
䓒	aqlf
玽	gqkg
噈	kyin
罯	lujft
垰	fhghy
㔰	aqhi
咶	ktdg
斌	yga
焍	ouxt
塰	itxf
栛	slll
舥	tecn
柝	sryy
嬰	mmvf
䟭	khtfj
巷	awn
铿	qjc
嬤	vysx
夯	dlb
㨧	rcdld
䫾	mtjte
䎿	btoy
井	fjk
䁵	hlge
㤷	nwykd
湌	iwye
暯	jajd
訟	ywcy
曺	gjhjs
痭	ueed
㨊	rdae
厂	dgtl
榵	sabg
補	pugy
䯱	degi
羣	vtkd
䍌	rmuk
刿	mqjh
鎁	qbbh
㹔	trggz
䖾	jpfq
炪	obmh
嘣	kme
銠	qftxe
㤼	nfclj
痑	uqqi
㳚	idyt
䎟	vdmj
㽼	uxhk
䂪	diqn
枼	ansu
缈	xhi
溟	ipjum
翐	nrwyn
霅	fyf
润	iugg
㵾	igeq
澺	iujnv
曑	jjje
崉	mijg
蹣	khayx
玓	gqyy
蝭	jjgh
衒	tyxh
羴	udud
鞪	cbtfl
㸁	oogw
㝰	pthy
䛷	ypqb
䐆	eesy
图	ltu
芸	afcuj
诲	ytx
㒅	wyqe
虨	hase
论	ywx
责	gmup
赁	wtfmw
䅏	tntn
淏	ijgd
蓜	asgn
裼	pujr
燌	ofam
䰰	fdmc
圠	fnnq
泱	imdy
䓐	adgn
涍	iftb
孶	yxyb
萗	apfi
畑	olg
嚶	kmmv
横	sam
䴸	swwbl
㘴	kwfd
䓗	awcn
够	qkqq
釳	qtnn
䤐	sgajq
蛀	jyg
迣	anpv
阉	udjnc
苻	awfu
傣	wdw
跜	khnx
被	puhc
狽	qtmyj
囤	lgb
㜁	vsjg
裟	iite
㪦	pgmt
㗻	kmnp
䉿	otuh
褗	puav
撘	rtwk
琬	gpq
郙	gehb
帼	mhl
窼	pwvs
䊖	ofmf
㛷	tdnv
漞	iehq
鏓	qtln
䙵	sfff
眣	hrwy
螀	uqfj
圬	ffn
诺	yad
傶	wdht
㐮	ufje
窪	pwife
珅	gjhh
涓	ike
媾	vfj
㓅	ush
淍	imfk
㽟	lefy
蹽	khdi
谱	yuo
鏅	qwhea
膸	edap
㑿	wvjs
凔	uwykh
㫕	jgqb
跮	khgf
㗂	kith
囯	lgd
鉻	qtkg
殜	gqasx
舴	tetfn
㦠	nogf
辠	thuj
㷽	oudk
恉	nxjg
黱	eudoe
俷	wecn
鏔	qpgwx
䬕	mtjjr
槠	syfjn
㢅	ygak
苒	amf
㲚	iitn
漌	iakg
䖏	haqy
廿	agh
矽	dqy
伎	wfcy
嫖	vsf
㝙	pggw
䵛	twif
镄	qxj
畤	lffy
籑	thdek
䓆	arrj
幅	mhg
㧷	rgdk
㩏	rlfo
蛴	jyj
奎	dfff
鏥	qpwj
䊉	opsy
羜	udps
覦	wgeqn
䩪	afpn
妥	ev
䢃	nkuq
芼	atfn
鞮	afjh
婹	vsvg
䜟	yfag
璠	gtol
洳	ivkg
硡	dpdc
㖊	kvfy
梽	sfny
愮	nerm
䙧	puto
翑	nqkgk
蜿	jpq
喓	ksvg
疮	uwb
㙛	fgefz
摸	rajd
鋉	qgki
㖸	khagi
晱	jooy
豲	edri
螡	yjju
䓶	agkj
伣	wmqn
癪	utgm
伐	wat
氏	qa
汜	innr
匼	awgkb
幣	umih
鬆	desc
椪	suog
賆	muah
墯	ndaf
掫	rbcy
塠	fwnpk
腸	ejgr
襳	puwg
曋	jsjhf
拫	rvey
睯	nath
錙	qvlg
㕓	dlff
眀	heg
勊	dqlv
瓃	glll
枮	shkg
是	j
糬	olfj
䔓	aytf
曎	jlffo
洓	igmi
腫	etgf
規	fwhq
帏	mhf
葎	atvh
䒪	acaj
䄂	pymg
蜣	judn
貟	cmuh
疡	unr
啠	rrkf
㔥	lcel
䅠	tjgh
箊	tywu
氈	ylkny
厗	dukl
掬	rqo
庮	ysgdn
蝖	jpgg
筸	tjfj
涼	iyiy
秎	twvn
蒏	apsg
记	yn
铤	qtfpf
誘	yten
懁	nlgea
龰	龰
挧	rngf
㷓	oqrn
尾	ntf
逑	fiyp
皥	rthf
書	vfjf
芆	acyu
冰	ui
爄	odays
封	fffy
娺	vccc
琉	gyc
帲	mhtfn
饯	qngt
砌	dav
䈨	tbve
㯤	swww
玨	ggg
㪁	wyncj
㨅	ramw
簁	tthh
斒	yynac
吉	fk
狭	qtgwc
峧	muqyy
㫆	ywiy
架	lks
拋	rdnl
㘎	kuntl
汆	tyiu
㲜	ootn
载	fa
嘺	ktdk
胺	epvd
蘜	aafo
古	dgh
㵓	ipjh
㾚	uhxf
霘	fimke
孢	bqn
厬	djtk
父	wqu
沊	pqii
按	rpv
雱	fyb
腴	evw
乵	unnd
䵍	amwb
㫾	jimk
䍩	udty
粗	oe
崥	mrtf
㰇	sfag
㶡	moi
汃	iwyq
詻	ytkg
燭	olqj
籌	tfnf
槦	syvh
㖱	ywtk
及	ey
椇	shwy
衙	tgk
㲧	tfnjd
袇	pumy
銉	qvfh
嘬	kjb
身	tmd
胟	exgu
镂	qov
㪀	gfty
邅	ylkp
榼	sfcl
懢	nahl
瘰	ulx
媗	vpgg
㲎	tfnnv
㪧	wgkcw
鋴	qdqn
彅	xuev
滔	iev
圦	ftyy
堡	wksf
乩	hkn
麾	yssne
鐀	qkhm
䗉	jjjgi
钻	qhk
拒	ran
蒗	aiye
䚊	uwlq
约	xq
劄	twgj
耉	fttk
蜅	jgey
㢗	ytdka
銇	qdiy
敊	hihc
㾦	uukd
㸼	trth
匩	abhg
蝷	jyut
篹	thdbi
彻	tavn
褞	pujlm
笲	tcaj
幸	fufg
铍	qhc
鐨	qxjm
舅	vl
匆	qry
眐	hghg
藦	aysr
渓	iefw
庎	ywjk
富	pgk
䅪	tkhmq
瓈	gtqi
䠻	tmdx
臼	vth
趜	fhqo
㢜	yaln
扱	reyy
䚮	yen
國	lakgg
蟠	jtol
暻	jjyi
沁	in
朠	eamd
犩	tvrh
涻	iwfk
儨	wrrm
簜	tijr
鐕	qaqj
㹒	troy
溋	iecl
柞	sth
焤	ywfo
䉋	tvnh
齔	hbxn
眂	hqan
涭	iepc
齑	ydjj
䈀	tmmj
橵	saet
闾	ukkd
豠	eegg
塞	pfjf
碝	ddmdr
銼	qwwf
瀶	iahk
䥔	qsoy
箐	tge
掊	ruk
陪	buk
泏	ibmh
旴	jgfhi
㼊	gbny
浞	ikhy
媝	tovf
镞	qytd
㵏	iayf
鬼	rqc
䀣	hntt
杕	sdy
䊡	ojlc
笽	tlfg
売	fpqbb
㡲	yae
庝	ytui
庘	ylkn
旻	jyu
凷	fbk
䓤	aqrno
砼	dwa
影	jyie
牣	trvy
䄠	pyyg
爏	odth
坸	fqkg
棳	sccc
礕	nkud
趚	fhgir
璁	gtl
䩢	afrr
锼	qvhcr
墠	fkkf
刖	ejh
悷	nynd
忹	ngg
煬	ojgri
撠	rfja
䈢	tcks
㗆	kafh
斻	ytmn
䈿	tpju
丛	wwg
霺	ftmt
㻡	gans
酝	sgf
泬	ipwyg
坰	fmkg
崷	musg
抳	rnxn
汉	ic
获	aqt
蓱	aiua
䒤	ajf
渪	itky
崚	mfwt
測	imjh
社	py
思	ln
濗	iajh
誜	ycwt
佈	wdmh
慖	nlag
註	yyggg
䚑	lmhq
淢	iakgq
敥	oohc
㩯	rtxi
襑	puvf
搆	rfjf
瀻	ifaw
㼎	rcyq
汣	iqyyu
愈	wgeny
霣	fkmu
諲	ysfg
㖯	mgkx
䅣	trgg
㲏	thgnt
怆	nwb
狾	qtrr
傮	wgmj
㐏	gnb
腎	ahne
㼵	jggn
㠟	mtqi
鎄	qyeyv
䕖	abtp
甭	gie
崝	mgeg
钕	qvg
鍿	qgvl
嗰	kwld
凤	mc
菾	agdn
冂	mhn
眩	hy
窫	pwdd
啎	tfgk
錈	qudb
梒	swykc
䗒	juog
弡	xang
䬐	mtjv
讁	yump
礰	ddth
凩	msi
淵	ijgg
㑑	wthgt
滵	ipnm
襞	nkuek
㶮	gmwo
艢	tefk
訦	ypqn
譢	yuep
諒	yyiy
毝	tfne
覰	haeq
璷	gget
瓜	rcy
堐	fdff
野	jfc
蚥	jwqy
烱	omwk
瓔	gmmvv
粣	ommg
涿	ieyy
齲	hbty
陊	bqqy
熜	otln
桽	swwfx
伬	wnyy
癥	utmtx
䀤	qhhf
省	ith
㭅	sdgu
㽧	luxx
悱	ndjd
屦	ntov
俻	wtlg
㭳	sftb
腝	edmd
彷	tynw
镤	qog
筹	tdtf
襫	pudj
䆉	tlcx
㾍	udmj
霪	fief
刣	ckjh
耑	mdmjn
独	qtj
阍	uqa
朣	eujff
氮	rno
㸷	dhvh
窻	pwtn
評	yguh
疴	uskd
㡶	ykwi
姅	vufh
隉	bvag
豫	cbq
㻭	gyxf
沧	iwb
极	se
䥌	pjjq
瞔	hgmyg
事	gk
焣	bcouk
砭	dtp
旊	ytgn
発	wfqb
㳾	iudn
宖	pxcu
剣	wgkjp
錔	qijg
毶	tfneq
涗	iwkq
櫃	sakm
䴴	swwk
凅	uldg
帑	vcm
㨐	rwks
魖	rqcge
鄩	vakb
西	sghgf
癀	uam
㭷	slln
倣	wyty
傆	wdri
峽	mdww
晔	jwx
笁	taf
濜	ivhl
壔	ffnf
庄	yfd
藌	apnj
浒	iytf
沃	itdy
銱	qkmhx
屏	nua
㸎	obbb
㤫	denu
莓	atx
㵉	iiss
熕	oamyp
瘽	uakgh
挆	rmsy
揦	rgkj
柡	sfiyo
潢	iam
㼚	ymgn
繴	nkui
竜	ujnb
啒	knbm
睿	hpgh
煀	onbm
崶	mfff
蝫	jftjn
㼅	gyaw
謂	yleg
烮	gqjol
贪	wynm
坘	fgxg
蟦	jfam
䞌	mtdg
蠺	gdgjd
諙	yqaj
㖐	kkvt
猤	qtwd
龯	龯
籷	otanj
巐	myma
䝌	eccc
噵	uthk
贏	ynkyy
殘	gqaa
跘	khufh
箙	tebc
冝	pegf
佮	wwgk
蔝	ahou
凐	usfg
竡	udjg
嵜	mukha
岟	mmdy
劙	xejj
㕺	kkgn
犃	truk
懪	njai
懧	npns
楂	ssj
穇	tcceb
袛	puqyy
酧	sgpfc
抎	rfcyp
㠤	myke
连	lpk
䐜	efhw
壿	fusf
娵	vbcy
嘳	kkhm
嶴	tmom
煝	onhg
㽶	unv
軇	tmdf
禪	pykf
咬	kuq
朔	ubte
賨	pfim
盧	hall
嘢	kjfb
䪤	djdl
䄷	tdgo
䘳	puqg
滺	iwhn
偪	wgkli
毮	ritn
悛	ncw
謈	jawy
釄	sgyd
牟	cr
䎦	dioo
襬	pulx
岬	mlh
嫢	fwhv
煶	ojgh
灿	om
罽	ldoj
畊	lfjh
厀	swib
㗒	kyey
玆	yxyx
㥘	nfcyb
淙	ipfi
鎇	qnhg
㵷	uiuh
朒	emww
㥷	ydwn
翋	nug
询	yqj
㜃	vwygi
䑎	ewwg
俒	wpfqt
鈫	qyy
㙱	kgnf
㽬	gkll
萶	adwjw
糪	nkuoe
䕷	aysi
瓐	ghal
翠	nywf
䈄	tbib
䥡	qthsg
㽿	urcy
跆	khckv
馂	qnct
億	wujn
亻	wth
䝨	jcmu
䪁	afoy
摓	rtdp
撱	rbde
㓄	cccq
蜋	jyveq
詗	ymkgl
邼	agbh
勻	qfd
祹	pyqm
嫷	vbde
㚮	vpmn
汤	inr
踁	khgao
隗	brq
啃	khe
㳸	iawx
锽	qrgg
歿	gqqc
鐇	qtol
譟	ykks
蕧	attt
殡	gqp
獹	qthl
㥦	adwns
侰	wvtk
䛂	ytah
遥	er
萓	apeg
篷	ttdp
唳	kynd
涔	imw
怢	nrwy
㔙	ualn
颻	ermjs
氨	rnp
镝	qum
髻	defk
㻨	ahnyo
㮴	svhc
欚	sxej
谙	yuj
嵪	mymk
椨	sywfw
巗	mkkt
婟	vldg
某	afs
䰛	gkmn
䒞	apqb
㒍	wcci
胳	etk
奷	vtfh
萏	aqvf
䠱	khnjq
旿	jtfh
笮	tth
䑮	tees
替	fwf
畛	lwet
㤎	lknu
涋	ipdy
橾	skks
呙	kmwu
犭	qte
䑘	vudax
䣢	diab
怟	nqay
劍	wgkj
㓷	thsj
涄	imgn
䐣	ekmy
疿	uxjk
皅	rcn
阽	bhkg
秿	tgey
檌	sldd
淎	idwh
透	tep
䶘	hbug
䊱	owwg
喒	kthj
辶	pyny
䓻	apfv
暜	uujfw
㱒	hskf
佤	wgn
倃	wthk
聼	nbfn
㥎	tqtn
㢀	ygmi
檆	sook
訓	ykh
溭	ilwt
劦	lllb
萛	ahaj
曒	jryt
䠗	khtd
嶎	mnff
蓭	aydn
蔳	aige
咡	kbg
磌	dfhw
敷	geht
犋	trhw
切	av
簝	tdui
㨽	rgkjy
瘛	udhn
喔	kngf
眥	hxhf
坕	rhyf
䞳	fhuk
鎙	qube
梲	swkq
䀉	tdkl
坩	fafg
倬	whjh
厹	vcu
婉	vpq
硼	dee
噼	knk
衤	pui
尕	eiu
䂯	dyfg
鍯	qqrn
㛃	dhvv
贝	mhny
㠝	mfwm
袤	ycbe
样	su
伌	wdbn
㚖	rdu
橑	sdui
楅	sgkl
阑	uglim
俧	wfnya
㨆	rssyw
㤑	ndkg
䍉	rmkw
㩞	roos
翄	nfcy
邿	ffbhd
乾	fjt
鋤	qegl
蜯	jdwh
侓	wvfhz
㴢	iiwh
赗	mjhg
箯	twgq
菑	avlf
羕	ugyi
忭	nyhyd
㝊	pcu
糱	btwo
咸	dgk
鑍	mmqf
䃴	dyfj
媆	vdmdr
瘠	uiw
垬	fawy
謜	ydri
裔	yem
钙	qgh
哿	lksk
䘗	tmghu
蚣	jwc
塂	fawn
㑄	wxgu
㢛	ywgwl
㧄	rbh
襢	puyg
寗	pntf
逨	swwp
栖	ssg
䠃	khgy
㿙	ulld
羇	lafk
䆤	pwtt
璬	gryt
㡰	ygfk
莘	auj
铱	qye
箛	tbry
佟	wtuy
㖒	kuxt
倿	wuvg
梵	ssm
嚜	klffz
揜	rwga
黯	lfojq
椙	sjjg
倗	weeg
嘟	kftb
値	wfhn
㪯	yfhj
䄏	pyad
䯯	deit
棒	sdw
灲	ojh
勶	tycl
鍋	qmnk
铷	qvk
礦	dyaw
审	pj
咥	kgcf
燪	oaqn
扸	rthn
的	r
湗	ifff
粱	ivwo
㒪	wahe
兺	wvkx
䖠	jnyy
娘	vyv
䇿	tgki
㵂	iyao
嚲	ybkf
榛	sdwt
㲡	sfin
姹	vpt
镩	qpw
㽸	upqv
虦	aahm
鎱	qfke
䆰	pwak
榀	skk
䩼	aftp
堇	akgf
寡	pde
嘎	kdh
䣋	tobh
㨯	rybb
怓	nvcy
厞	ddjd
讧	yagy
捅	rce
剌	gkij
䥋	qybo
裁	fay
沦	iwx
䨫	fswq
畷	lccc
璱	gggt
洏	idmj
殍	gqeb
接	ruv
桚	svqy
晆	jffg
萼	akkn
鞠	afq
䄟	tfni
牓	thgyd
䛖	yjxt
酹	sge
㥻	dtnnp
岥	mhcyc
壈	fylt
框	sagg
搚	rlle
㐩	fjfj
煔	oohk
㣢	tuxtq
邙	ynbf
旭	vj
艝	tefv
璌	gpgw
䢵	fcbh
㗩	knrg
拺	rgmi
䕚	aakm
艥	tekt
踔	khhj
嗝	kgkh
刲	ffjhl
賵	mjhgb
灤	ixys
咞	kgah
浆	uqi
裈	pupl
曯	jnijz
盕	imyl
耇	ftqk
刡	najh
穻	pwgf
諺	yute
䓥	tyaj
㓁	pwuv
憵	nkun
吥	kgiy
従	tuhy
笶	ttdu
龷	龷
笺	tgr
孀	vfs
郡	vtkb
床	ysi
矠	cbtja
勷	ykkl
榜	sup
㒬	fqgd
㣻	qnup
煪	ousg
匋	qrmk
蟒	jadax
㡟	mhgj
諡	ywgl
军	pl
㷿	owgw
籜	trlf
㖫	kfwt
䠢	alph
䆈	tnip
幾	xxdtu
擽	rxrs
惸	nqjb
番	tol
鉴	jtyq
郳	vqbh
芬	awv
牋	thgar
䉱	tpuk
䔎	agkpu
狪	qtmkn
誖	yfpb
钞	qit
鞥	afwa
縶	fufi
嗡	kwc
錴	qfwf
巘	mhads
讑	ywga
蝼	jov
掛	rffh
䈚	tckn
裎	puk
秙	tdg
䐄	eqvg
鈥	qoyh
瑧	gdwt
阣	btnn
徳	tfln
䛽	ytfvq
胭	eld
猀	qtit
柀	shcy
皾	flmc
部	uk
呒	kfq
鬖	dece
厐	ddxv
耢	dial
涥	iybh
晜	juxt
銩	qtfcn
橁	stqj
曳	jxe
㨃	rybg
九	vt
㢯	xnanl
渮	iask
晭	jmfk
佋	wvkg
眦	hhx
伱	wwiy
茸	abf
妖	vtd
掱	rrrj
犇	rhth
抪	rdmhz
袭	dxy
砕	dvfhn
柦	sjgg
籢	twgt
搸	rdwt
恇	nagg
帮	dt
貧	wvmu
乮	qtbn
䢜	vpmp
㸹	tref
芜	afqbp
酲	sgkg
附	bwf
酪	sgtkb
沼	ivk
唛	kgt
橨	sfam
鼋	fqkn
衧	pugfv
贑	ujam
躽	tmdv
㚣	vvfs
䉩	tsak
㫦	whtj
锑	qux
倴	wdfa
溔	iugo
闿	umnv
㴓	ilny
鋙	qgkg
傇	wabg
禟	pyykg
覍	ihqb
㖪	kakg
妷	vrwy
㼌	rcyy
現	ghqn
奲	dftf
禿	tqb
俕	wpsy
㒎	wgdd
示	fi
匍	qgeyb
蘍	atgl
㴭	ipwh
㔛	fklb
汞	aiu
爈	ohan
㺸	wmyg
㡆	mhyq
㷏	ttfo
橬	saqjq
䩟	afgw
扫	rv
䓮	acbth
褚	pufjy
泡	iqn
蓰	ath
浂	iudy
銵	qtmtw
覃	sjj
疆	xfg
挳	rgva
熤	onug
症	ugh
英	amd
挑	riq
源	idr
荌	apvf
戕	nhdac
晖	jplh
芃	amyu
檘	snku
鈅	qega
藠	arrr
㲿	iytu
鎂	qugd
暑	jft
㨿	rham
劅	lqjj
䊝	oton
樒	spnmd
倈	wsww
樝	shag
詁	ydg
杶	sgbn
晳	srjf
桉	spv
㡂	gqjh
竽	tgf
䏢	ehcy
䎳	beg
吊	kmh
答	tw
齞	hbkw
扨	rvyy
鬶	fwmh
琮	gpf
䉴	tyke
䏀	bgkj
鉀	qlhr
蜇	rrj
飞	nui
㳺	irtb
火	ooo
昇	jtaj
卟	khy
摽	rsfi
濁	ilqj
蘳	aamf
䇻	tntnz
㱵	gqfm
限	bv
槾	sjlc
㷙	ouej
匴	atha
螙	sjju
蔉	auke
䎹	tobf
瞕	hujh
耷	dbf
䚋	kmhq
錯	qajg
釦	qkgr
済	iyjf
蕏	aqtj
忌	nnu
囥	lymv
棯	swyn
悧	ntjh
窌	pwqb
䅄	tlll
蟔	jlfo
耠	diw
䢂	lug
玜	gwcy
坑	fym
愃	npgg
尒	wiu
衍	tif
朹	svn
随	bde
乎	tuh
唶	kajg
臠	xyxw
逛	qtgp
榧	sadd
斎	yjfi
㓻	lghj
䤇	sgpc
搑	rabg
耪	diuyk
葰	awct
髟	det
裭	puhm
実	pdwu
繛	gxij
巬	amfw
謍	oopyq
籵	ofhb
漚	iakk
䣨	sgta
㞂	dnev
槷	fwfs
㼛	gagn
睍	hhqn
簰	tthf
㛍	vdww
樀	sumd
诐	yhcyk
㒶	wrf
艤	teut
鈐	qwyno
䬂	mtjth
搣	rdgtq
怂	wwn
罚	ly
䇔	ynkym
脝	eybh
圲	ftfhn
姱	vdfn
㿮	mdhc
迲	fcpi
圈	lud
敡	jqrc
盪	ijgl
㜉	vvkc
芰	afcu
㠖	mugtp
蓓	awuk
涐	itrt
䧉	bjfg
䒵	avbf
㖀	kvfh
氧	rnu
女	vvv
酎	sgfy
巍	mtv
䇕	ufdj
誽	yvqn
鬒	defw
㻜	gwwh
涶	itgf
虣	gahm
剙	uavw
掞	rooy
盍	fclf
䟾	khcc
㮮	sdhr
硖	dguw
怠	ckn
彑	xgd
冫	uyg
郁	deb
仁	wfg
臂	nkue
睧	hqaj
庢	ygcfz
邺	ogb
蜰	ecju
寣	pnhy
氒	qafj
㐇	vnb
鋏	qdww
塝	fupy
礴	dai
䜌	xyxy
㦶	agcfw
器	kkd
悊	rrnu
啟	ynkt
齴	hbue
䣌	yqab
鈂	qpqn
玼	ghxn
申	jhkq
喤	krgg
澋	ijyi
狼	qtys
䙾	pxhq
㳣	iftx
璞	gogy
鉄	qrwy
巿	gmhkq
纣	xfy
櫡	stfj
怞	nmgx
㣤	taat
蒩	atego
覒	tfnq
䵦	lfofa
阸	bynn
哏	kve
辯	uyuh
柜	san
嫎	vupy
阀	uwa
㡔	cbth
挦	rvfy
镃	quxxp
愚	jmhn
撄	rmm
摹	ajdr
㡎	mhce
斄	fitw
埛	fmwk
釡	wqfi
幇	fffhs
帖	mhh
矗	fhfh
扅	ynqq
㤒	ndfh
乻	ywunm
礘	djxo
坧	fdg
䧓	bmfk
楫	skb
讥	ymn
㪊	vtkc
㨎	rdmd
寐	pnhi
瘼	uajd
䎧	diuk
烧	oat
辪	hwnu
襟	pus
蓺	afwy
㙑	tkmf
撯	rudh
䆥	pweu
旰	jfhr
噊	kcbk
䃬	dmrc
㼠	pxgn
䟱	khgig
迉	npe
䀃	elf
纂	thdi
䖎	bham
琻	gqg
哘	ktfh
待	tffy
迢	vkp
嶢	mffqp
馈	qnk
慣	nxfm
篐	tsah
㵽	illl
趉	fhbm
䂩	dldy
呄	edf
憿	nryt
炰	qnou
牳	trxu
濾	ihan
绊	xuf
䓯	agxu
钎	qtf
坬	frcy
荢	apgfz
䆜	pwder
繇	ermi
阔	uit
䨪	ffjf
僻	wnk
曁	rxag
䛣	ymgnm
㟖	mgaj
跿	khfh
炡	oghg
烨	owx
瞈	hwcn
㬖	jynkd
倁	wtdkn
冐	jef
堑	lrf
枖	stdy
㾞	usgdf
皺	qbtc
䞘	fhtn
羶	udyg
侼	wfpb
懬	yamn
橢	sbde
㭖	sway
碇	dpgh
揊	rgklv
吭	kym
㻓	gbcy
湽	igvl
呱	krc
蓂	apju
洩	ijxt
漇	ithh
晿	jjjgz
昷	jlf
眱	hgxw
嗲	kwq
㠬	akfwn
擞	rovt
圃	lgeyv
㝋	pbj
㴺	iidw
䨛	fsrj
叓	gkhc
噏	kwgn
簕	tafl
遙	qrmp
皰	hcqn
炀	onrt
畒	ylwy
兡	dqdj
饼	qnu
磺	dam
㢽	xbxn
衴	pupq
㭜	sadtf
蠥	btwj
勐	bll
脟	eefy
咿	kwvt
慳	nahf
灰	do
氰	rnge
薯	alfj
箝	traf
墬	bxef
揖	rkb
䁕	hnaj
鎉	qjng
跨	khd
碆	ihcd
赍	fww
血	tldf
㫑	jln
注	iy
䓀	afkfd
姇	wfvf
躵	tmdnt
篎	thitu
螵	jsf
熼	olaw
专	fny
徨	trg
䈅	takg
磀	dubp
垀	ftuh
化	wx
貐	eewj
丵	oguf
蟘	jwam
遅	nudp
箠	ttgfi
趄	fhe
稪	ttjt
麨	swwtz
搦	rxu
皻	haec
垣	fgjg
泐	ibl
高	ym
㺠	qtpy
瓴	wycni
䢱	flmp
鄚	ajdb
翼	nla
䤟	qpmn
蠎	jadaq
铺	qge
牛	rhk
缍	xtg
蚱	jthfr
斔	yjvw
逯	vipi
黼	oguyu
䃿	pyfw
挎	rdfn
㥝	nxbg
䇯	tbf
倭	wtv
謊	yayq
岰	mxln
䚱	yiy
蚔	jqan
稩	tleg
㚆	yjtu
禹	tkm
对	cf
竛	uwyco
鍑	qtjt
圉	lfu
歹	gqi
珮	gmgh
梇	sgahs
榚	sugo
㧉	rrnn
㯱	gkhse
仃	wsh
佘	wfiu
衟	tvdh
䠫	khbi
䤌	sgwk
視	pyhq
鄀	adkb
㲽	ivyyc
托	rta
䄘	pyuy
腓	edjd
衕	tmgh
鞣	afcs
焓	owy
㿴	dbhc
蜮	jak
䨽	djdnb
蜎	jkeg
栞	gdfs
哺	kge
樻	skhm
蹂	khcs
髱	deqn
瘡	uwyk
㑅	wthg
虵	jbn
㽱	unhk
荡	ain
㽘	lymn
㼻	twwny
䒮	apmy
㷕	usgoq
䄮	tfwyl
傗	wyxl
辺	vpvx
㭺	sdjn
罍	lllme
貤	mbn
琛	gpw
铰	quq
嗨	kitu
桱	sgva
恾	nayn
㾎	ummg
沸	ixj
愜	nadwx
䵂	swwdj
䰙	gkmc
闼	udpi
嵵	mjff
䜤	yawy
藶	adth
埝	fwyn
磣	dcce
甆	uxxn
䣰	sganh
訰	ygbnd
梱	slsy
㲌	tfneu
河	isk
家	pe
胆	ej
䠚	khpy
鬓	depw
甂	ynmnv
肠	enr
䶖	hbwn
婅	vqoy
橇	stf
处	th
篈	tfffm
卒	ywwf
东	ai
䞯	fheb
䧑	bpghr
蠱	jjjl
㢸	xxty
噩	gkkk
䆚	pwmkg
齡	hbwc
愿	drin
宴	pjv
訧	ydnn
䝖	eery
跍	khdge
潪	itdj
灾	po
辀	lteyt
䈭	trqc
敧	dskcw
著	aft
去	fcuf
啹	kndg
㵱	isff
䰩	ftjc
雸	faff
薧	aypx
㔚	tdln
倆	wgmy
㣌	hket
铗	qguw
㢪	xfnn
䙗	puud
痸	urmj
枏	smfg
穾	pwtd
茮	ahiu
璋	guj
剛	mumj
葥	auej
稻	tev
利	tjh
䓹	awyeq
哒	kdp
㓧	wynjd
嫼	vlfo
匫	aqrj
壖	ffdj
嶍	mnrg
羷	udwws
㙂	fukq
腗	emgj
儽	wlli
笔	tt
绕	xat
睩	hviy
䏽	eukg
瞰	hnb
璟	gjyi
礩	drrm
奝	dmfk
煷	oypm
演	ipg
眇	hit
裓	puaa
㹈	fithe
殈	gqtl
蹮	khsn
倰	wfwt
邤	rbhg
媖	vamd
迦	lkp
枬	smyg
䊄	amyo
肨	edhh
䅦	talg
㛌	vcrh
㥰	nvhc
妌	vfjh
覨	kkfq
㝣	pdhd
槉	sutd
陫	bdjd
檡	slff
㪟	yjty
懕	djen
裉	puve
暖	jefd
㹎	trli
昼	nyj
菼	aoou
鑖	qalt
慼	dhiny
鎟	qccs
泯	ina
楸	sto
槕	shjs
芮	amwu
憣	ntol
眙	hck
㪕	hjhc
塇	fpgg
爿	nhde
髷	dema
菦	arpu
㷋	oooyu
导	nf
醐	sgdej
柲	sntt
筮	taw
㤿	ndjn
夂	ttn
磰	dudk
蟸	ejju
呲	khxn
勩	anml
㪅	gmwc
莂	aklj
狅	qttfo
墟	fhag
䵝	lfonh
㮵	syty
㯃	sswi
重	tgj
蝈	jlg
秳	ttdg
羺	udfj
天	gd
賶	mwykj
䖪	hxju
捻	rwyno
侭	wnyu
兿	urvc
賮	vhgm
㸜	nhdaj
浘	intn
㟲	mdri
挮	ruxt
扏	rvn
貪	wynma
他	wb
䝭	mqkg
娆	vat
嶓	mtol
葄	aetf
赶	fhfk
豗	gqei
荅	awgk
摣	rhagg
窉	pwgwg
栳	sftx
屺	mnnj
袀	puqu
潞	ikhk
耜	din
蘁	agkk
墤	fkhm
嚟	ktqi
岈	mah
㬷	elsy
㳫	ivf
䠳	tmdmb
跙	khegf
㫔	jhf
峑	mwgf
㒰	tyaf
栔	dhvs
铏	qgaj
秄	tbg
嬐	vwgw
鍸	qdegl
桕	svg
扲	rwyn
逶	tvp
圽	fqrt
偐	wute
衽	putfp
黺	oguv
陂	bhc
婠	vpnn
玸	gqnn
栭	sdmj
䍗	lyxu
䃔	dpkk
銞	qjqf
饺	qnuq
彺	tgg
㠯	nhnd
診	ywet
䣗	rdfb
殙	gqqj
㖢	kyhx
垅	fdx
偒	wjgr
梠	skkg
瞾	hhpa
霙	famd
眓	hantf
辁	lwggg
監	ahnlb
央	md
茜	asf
徯	texd
擜	rfmd
偅	wtgf
㝪	pfuy
懋	scbn
踿	khtok
酸	sgc
熂	orno
蒡	aupy
䄧	tenb
绣	xtenr
奃	dqay
螝	jrqc
晙	jcwt
羱	uddi
贜	madts
埱	fhic
沴	iwet
䄸	trgs
槁	symk
娐	vebg
澐	iffc
䥈	qada
䶊	thlfs
胉	erg
醺	sgto
筊	tuqu
笀	tynb
覕	nthq
擆	rafj
㮆	swud
埉	fdww
盠	xelf
悼	nhjh
暮	ajdje
徇	tqj
珦	gtmk
躰	tmdgj
㫠	jufh
㣍	cket
箔	tir
篯	tqgr
䍫	udpx
䝇	wqei
䘣	puhx
櫐	llls
䠼	tmdjy
芺	atdus
銿	qceh
祛	pyfc
捞	rap
㫌	ytgh
僺	wkks
媋	vdwj
䵖	ahnih
䴮	swwml
盷	hqug
政	ght
埠	fwn
紧	jc
弖	xgf
䍰	udld
坳	fxl
揓	rytb
耐	dmjfo
薜	ank
杇	sfnn
萨	abu
玝	gtfh
㣼	nvyy
厅	ds
奴	vcye
勦	vjsl
䥮	qsab
馜	tjnx
䒧	afcul
阕	uwgd
朊	efq
旔	yvfp
范	aib
蝊	jpgh
㴀	iatp
䜠	yrrm
謣	yffn
䑄	ethj
㭉	asu
䤉	sgnl
䣇	fiyb
䎬	dilc
犾	qtdyi
囼	lckd
闸	ulkl
嚛	kxrs
彣	yee
县	egc
跋	khdc
㫂	yaor
黖	lfoqq
崩	mee
谨	yak
㣪	tefc
襕	puuil
埰	fesyh
嘆	kakw
㣮	tfmfn
萴	amjj
珇	gegg
囶	lwfd
联	bu
镉	qgkh
垨	fpfy
泿	ivey
雿	fiqb
锝	qjgfy
郹	hdbh
䜒	ytmd
獆	qtrfb
橒	sffc
蚕	gdj
蒾	aopu
圸	fmh
奋	dlf
臤	ahnc
䓂	ayf
格	st
蓋	afcl
燹	eeo
蔔	aqgl
䆹	pwuf
脮	eevg
籾	ovyy
貂	eev
櫽	beasa
稊	tuxt
彯	sfie
蜀	lqj
垻	fmy
洐	itfhh
堙	fsf
瘑	umnk
邰	ckb
趤	fhpd
茾	agaj
熍	opkk
辮	uxiu
㞰	mtfh
㦏	nnnw
鬂	derw
仆	why
覤	hamq
詠	yyni
攐	rpfe
屜	ntan
洇	ildy
䃸	dwwg
刔	nwjhx
泃	iqkg
恙	ugn
淡	io
悬	egcn
杔	stan
錾	lrq
㨘	rith
搨	rjng
䕰	aotl
戌	dgn
崓	mldg
㙘	fsvg
樜	syao
僸	wssi
莑	atdhe
霉	ftxu
竤	updc
焬	ojqr
剳	awgjh
淚	iynd
㙈	fham
㛜	whtv
䪫	ujga
庛	yhxv
嬇	vkhm
叱	kxn
氁	tfndd
䤖	sgji
䶎	thlk
腑	eyw
䓳	atve
拯	rbi
嘛	ky
醽	sgfk
蠛	jal
迷	op
㣊	ter
㤲	dwwn
釤	qetp
滀	iyxl
航	tey
逹	fufp
孊	vysd
琼	gyiy
㮕	sdmd
㧑	ryly
潽	iuoj
叉	cyi
瞘	hakk
憈	nhag
䣟	aqab
婇	vesyj
作	wt
覽	ahnqn
譾	yuen
玶	gguh
醕	sgyj
䏨	ewnn
䰀	detv
笧	tmmg
盄	xhlf
馎	qngf
㙜	ymkf
冉	mfd
蛗	wnnj
勖	jhl
衂	tlvy
炱	cko
蠭	tdhjl
锞	qjs
挊	rhgh
㲻	wiy
賛	fwfm
矷	dbg
蚲	jguh
训	yk
憳	nvaf
黶	djeo
㿼	galf
从	ww
㞣	bhwv
炲	ockg
龻	龻
叕	cccca
漴	impi
䍨	udgh
模	saj
沢	inyy
䙄	putv
禗	pyln
蜲	jtvg
癉	ukkff
䁿	lfoh
认	yw
䤣	qtuh
㺓	qtgmc
欀	syke
葝	agvlp
嗃	kymk
哾	kukq
㕦	kduo
津	ivfhi
寅	pgm
䃪	dylg
暳	jdhv
嚡	kaff
跟	khv
襼	puac
䀓	hvyyp
珯	gftx
匄	qynv
㕨	kmyy
䛮	ythk
㽋	xyxno
䒶	ajxr
恔	nuqy
聗	bdww
膟	eyxf
喥	kyac
妱	vvkg
陽	bjgr
铬	qtk
鐠	quoj
穹	pwx
尿	niiu
豺	eef
摇	rer
侃	wkq
髪	dedcn
醶	sgww
諰	ylny
杋	smyy
徣	tajge
㦾	ynbv
㵿	irrr
菞	atqt
漶	ikknz
啻	upmk
䇾	tyf
体	wsg
嘪	klmy
婢	vrt
釠	qmn
絫	ccci
曧	jgkj
嶠	mtdkc
瞛	htwh
鎰	quwl
蘼	aysd
鄒	qbtb
鍄	qyiy
带	gkp
咃	kwbn
捷	rgv
啵	kih
㯨	ssoy
璝	gkhmo
踷	khfjf
㫢	jfcyc
偢	wtoy
錡	qdsk
茆	aqtb
歾	gqqr
䝵	mgey
鎀	qwhe
牢	prh
揄	rwgj
梊	rrsu
幄	mhnf
㵢	iflg
幓	mhcej
呺	kkgni
戉	anty
逇	fbpv
楲	sdgt
塙	fymk
傡	wuug
櫏	ssdp
損	rkmy
醸	sgue
銥	qyeyj
婛	vyiy
堈	fmum
贉	msjh
荙	adpu
㛠	vujg
虮	jmn
憜	nbde
謒	ywyka
清	ige
乹	fjnn
沯	idfp
稉	tgjq
蚝	jtf
皯	hcfh
譀	ynbt
嚉	kogf
緜	rmhi
來	swwi
聮	bxxo
淄	ivl
唅	kwykb
㕇	dudm
饬	qntl
趢	fhvi
㤠	gqjn
碲	duph
泓	ixc
㼣	djgn
蜐	jfcl
掏	rqr
渕	iudj
潠	innw
䤘	sgwgr
圿	fwjh
姧	vvfh
㛖	vcwt
㺖	qtnt
帋	qamh
胰	egx
揘	rrggs
矒	halh
躅	khlj
棽	sswn
䝺	yymu
蛦	jgxw
䛊	ykwy
祀	pynnv
䗭	jkkn
钤	qwynt
垦	vef
窘	pwvk
賘	myfy
磍	dpdk
袍	puq
哇	kff
聄	bwet
竞	ukqb
稿	tym
炽	ok
傓	wynn
惭	nl
脏	eyf
嶇	makk
㺾	gmkg
鞹	afybd
㬍	jgefp
祴	pyaa
潫	iudid
羛	ugxj
㿎	ufam
改	ntyq
劤	rln
䑻	teyb
钩	qqc
㧗	rhxn
侾	wftb
敪	ccct
寫	pvqo
蟀	jyx
壕	fyp
悀	nceh
苈	adl
茒	aqbj
蜽	jgmy
旬	qj
翱	rdf
洜	tkiu
愓	njgr
斪	qkrh
佰	wdj
謟	yevg
楔	sdh
愞	ndmd
洹	igj
䊗	orgg
蠧	fpdj
詄	yrwy
析	sr
工	a
䵊	myaw
䤯	qgae
䝸	mafc
佸	wtdg
䀸	rrhf
溾	irqc
秆	tfh
㣥	twff
喰	kwye
炠	olh
棾	sspm
髮	dedc
㾂	uckd
遟	nupk
趼	khga
鈍	qgbnk
㾵	uyfk
咊	kty
闰	ug
鉉	qyxy
刨	qnjh
冡	pfeu
䗛	jwhe
缞	xyke
掭	rgdn
㫒	jaj
螱	nfij
魘	djec
滞	igk
仺	wagf
䟺	khmy
鍺	qftj
擛	raas
捭	rrt
罪	ldj
䩮	afvi
㝸	irqb
淗	iqoy
备	tlfy
筎	tvkf
㨩	rytpk
弸	xeeg
烁	oqi
巻	udnbc
鑙	qtdj
囝	lb
䎸	bgkg
煾	oldn
召	vkfd
痒	uud
藊	atya
峾	irmjh
㷂	ahno
蔭	abwc
攰	fclv
㷚	oyps
塃	fayq
詑	ypxn
杹	swxn
葇	acbs
嬞	vatf
充	yc
蚻	snju
㫡	jtuu
䅢	tmeg
陼	bftj
詶	yyth
米	oy
亢	ymb
洰	iang
㤛	nwtf
鍵	qvfp
䴶	swwhv
䈒	tfmf
垛	fms
㹶	qttp
氂	fitn
醣	sgyk
圣	cff
莼	axg
訬	yitt
椺	swks
眸	hcr
㡴	yuda
桊	uds
䈆	tynd
赐	mjq
凑	udw
褽	nfie
巺	nngw
歨	hhuk
瞒	hagwk
㥬	nupy
䊴	otww
暝	jpju
㪪	gddc
䙑	puye
瓱	gnyn
嬍	vmgta
㮙	skkne
燯	ofwc
䣼	sgyi
甾	vlf
癗	ufld
㹙	troh
彆	umixw
潯	ivaf
俇	wqtg
峯	mtdh
墰	fsjh
齙	hbqn
偲	wlny
㖣	kukg
狨	qtad
謻	ytqq
砺	dddn
豴	eumdt
㣰	tton
徭	term
㦙	njmn
峎	mveu
劵	udlb
怈	nann
䛵	yepc
盘	tel
斀	lqjc
酤	sgdg
迴	lkpdc
鍧	qqyg
瞳	hu
袓	pueg
喁	kjm
繁	txgia
䥼	qqrt
狎	qtl
殲	gqwg
䄭	ttfh
㚓	dsun
䙣	pugd
煊	opg
暃	jdjdg
玹	gyxy
濿	iday
髬	deggw
㠃	mumd
揇	rfmf
麥	swwtd
犝	trufr
焟	oajg
褆	pujh
韼	ujtp
郍	tebhu
濬	ihph
鋷	qbcy
柨	sdmh
荫	abe
磦	dsfi
嫉	vut
缋	xkh
渿	isfi
㼺	yvhn
笠	tuf
䢮	flpd
躾	tmdd
蛃	jgmwd
㯳	saqt
俣	wkgk
启	ynk
描	ral
浇	iatt
蠲	uwlj
傴	wakk
䀟	hxjh
邔	nbhz
機	sxxt
轫	lvy
飃	mtji
㸘	wqls
艸	btbh
銝	qwsy
嶿	mfdj
闱	ufn
笱	tqk
秺	tpta
荕	aelb
凹	mmgd
棪	sooy
悉	ton
䖯	ffju
遮	yaop
禄	pyv
毌	xfk
鎠	qlgh
浤	ipdc
鞳	afakn
琳	gss
䔐	aiaa
琣	gukg
搿	rwgr
隋	bda
㻐	gcwt
㲛	tdkny
崍	msww
楘	cbtsp
曰	jhng
菈	aruf
㙩	fdui
㞀	dndo
醂	sgss
函	bib
霥	fpfem
婷	vyp
偄	wdmd
㓀	phu
㡼	yjxe
呟	kyxy
窙	pwfb
竍	ufh
㜝	vwyga
踻	khmk
䚖	fkkq
咟	kdjg
垟	fudh
䓄	aqtr
塮	ftmf
辦	uluh
蘶	atvc
䤜	qtan
䗊	jooya
㯔	tfns
㪐	yndc
䏞	egsy
簂	tlag
杰	so
峰	mtd
熗	owyk
湵	iugy
釯	qynnn
鑪	qhal
聋	dxbn
圓	lkmim
苷	aaf
剡	ooj
㝬	pdhw
梻	swxj
囪	tlry
䍬	udghz
尞	duji
簴	thaw
剏	uavy
㣏	djet
嗪	kdwt
穖	txxt
䪧	ujbn
伟	wfn
鐩	quep
栩	sng
瘄	uajdd
炘	orhx
熁	olle
殱	gqfg
雮	ftfng
卅	gkk
䛟	ydww
葧	afpl
鄱	tolb
塻	fajd
㜋	vuwl
丼	fjyi
萻	aujfu
庪	yrfc
䓱	ahxs
声	fnr
効	uqln
萚	arch
㖆	kmag
浧	ikgg
䢸	egbh
慃	nwcn
跳	khi
燻	otgoe
粳	ogj
㕱	kdnn
态	dyn
䛏	ynxn
腤	eujg
櫾	seri
澁	ihhh
㫫	jgog
晽	jssy
夵	diu
腛	engf
洖	ikgd
籯	tynyn
偶	wjm
阏	uywuj
畹	lpq
刬	gjhu
秴	twgk
䇣	twiu
掟	rpgh
昱	juf
籼	omh
㶖	iwho
㒘	wahu
㦽	deav
券	udv
趧	fhjh
硗	dat
搱	rnuh
帨	mhuq
艺	anb
兕	mmgq
劷	udln
卄	aghh
䖥	cbtjn
䐛	edbg
徰	tghh
伍	wgg
吨	kgb
㨀	rtgip
䚯	yjh
列	gq
彿	txjh
腮	elny
䪀	afpnf
袣	puan
吠	kdy
槸	sfwyh
㚹	vqtb
㐘	onb
蕾	aflf
岨	megg
甿	lynn
暣	jrno
鑳	qpfh
蹃	khak
湂	ikkn
鎋	qpdk
牦	trtn
煿	ogefi
缴	xry
㣙	tmgx
镪	qxk
舂	dwd
螗	jyvk
誸	yxyxv
诔	ydiy
鈉	qmwyk
喨	kypm
糊	ode
群	vtk
钛	qdyq
栂	sxgu
䅧	tujg
芒	ayn
䃺	dysd
䪮	ujqt
銡	qfkg
踶	khjh
䤴	qbib
嚞	fkfkb
䞣	fhry
蛢	juah
报	rbr
情	nge
㭏	sfnh
沓	ijf
帱	mhd
䉷	tkkt
奓	dqqu
菭	aick
潻	itwi
䘅	cexjx
沟	iqc
㣐	riet
廟	yfjee
矈	hrpy
郭	ybb
䈈	tecb
詫	ypta
俱	whw
㲨	abtn
馕	qnge
譲	yufe
爪	rhyi
篆	txe
崡	mbib
彜	xgoa
㑏	wpfy
蜕	juk
溿	iluf
詡	yng
貥	mymn
屔	rgnx
螢	oopjg
箳	tnua
襙	puks
到	gc
艂	teth
醍	sgjh
倯	wswc
遪	cccpg
㢼	xumi
䀨	htdg
賏	mmy
婃	vpfi
讷	ymw
瑈	gcbs
䣒	khgb
奌	hkdu
指	rxj
丕	gigf
銳	qwkq
踒	khtv
訥	ymwy
㪽	gjrj
琲	gdjd
㗚	kssy
螣	eudj
㒚	wean
婋	vhamt
䅁	pvtu
肋	el
㓿	twij
秷	tgcfv
䥱	qpvo
嫃	vfhwy
媿	vrqc
䀒	htfh
㵨	nkuif
宮	pktk
轶	lrw
诈	yth
菹	aie
殌	gqga
猱	qtcs
绨	xuxt
㝟	pghq
併	wuah
罬	lcccq
㵴	idnt
㳪	igik
茁	abm
昰	jghf
郛	ebb
㱠	gqdg
拻	rdoy
醊	sgcc
憶	nujn
䛓	jtyy
惤	nxyx
蒼	awyk
獛	qtoyt
忴	nwyn
釱	qdy
鍼	qdgt
剖	ukj
朎	ewyc
拱	raw
潦	idui
墳	ffam
譔	ynnw
叶	kf
较	lu
岶	mrgo
乡	xte
䦅	qudkp
㕂	dwyn
崏	mqaj
诇	ymkgf
㵅	iwym
逊	bip
嗴	kudc
溣	iwwa
汈	ingg
樿	skkf
㮘	scbt
嗖	kvh
黹	ogui
螷	yrtjk
䃉	dnaj
㑫	wwyn
碶	ddhd
覀	sghg
濚	ioos
㗀	kxxm
笸	takf
鄗	ymkb
㲩	tfnnb
諊	yqoy
蘵	abuj
缏	xwgq
亽	wyu
韵	ujqu
㚬	vqug
揨	ryps
炇	otys
䎛	ftxky
㓦	djjh
哼	kyb
诣	yxj
躬	tmdxx
田	lll
㪎	dwwc
跐	khhx
䝹	mpqb
㨕	recl
薔	afwk
煘	odgt
擲	rusb
㕬	kwcy
䐘	eefc
鐄	qamw
䪯	oopj
䃮	dfup
蟌	jtln
碴	dsj
锠	qjjgg
膅	eyvk
糐	ogef
馠	tjwk
踥	khuv
謠	yqrm
甬	cej
烛	oj
䃟	daet
看	rhf
翥	ftjnr
狑	qtwc
莡	akhu
忯	nqan
纱	xi
娒	vtxu
據	rhae
咵	kdfn
劭	vkl
腭	ekk
硾	dtgf
䰥	akgc
郞	yvebi
鏋	qamy
睉	hwwf
屖	nuk
壬	tfd
獌	qtjc
猦	qtmj
艣	tehl
㣄	xias
袔	pusk
匾	ayna
枆	stfn
䎴	bfjh
銽	qqak
艚	tegj
䃎	ddqq
肻	hpef
巊	mmmv
揚	rjgr
醷	sgun
怡	nck
一	g
䖩	jntt
湪	ixey
弤	xqay
䎰	diar
烞	oshy
夘	qbhb
施	ytb
菍	awynj
梅	stx
梿	slpyz
皛	rrrf
䓎	aoqy
㖹	kwvl
坓	fjff
晊	jgcf
樛	snwe
䦸	ujmc
獍	qtuq
嗅	kthd
滒	iskk
䚀	tehq
恒	ngj
邍	tlvp
郥	mbhk
庾	yvwi
囁	kbbb
㿓	udwh
衠	tfhh
㕗	ugqc
㯇	sdjf
萾	aecl
暰	jtwhu
獷	qtyw
量	jg
託	ytan
矢	tdu
鍘	qmjh
鈲	qrcyq
㑢	wfcb
靳	afr
原	dr
钀	qhad
㴉	iccf
棴	sebc
醞	sgll
蓬	atdp
仛	wtan
黅	amwn
訹	ysyy
舿	tedn
勒	afl
瘗	uguf
铻	qgkgf
瞚	hpgw
㖴	kaqr
冋	mkd
俞	wgejp
漛	iudi
踼	khjr
䛌	yqnn
㠻	ftmh
帣	udmh
季	tb
揾	rjlg
汻	itfh
伫	wpg
䒜	arhj
譼	ahny
罠	lnab
帝	up
錩	qjjg
垄	dxf
裷	puub
峩	mtrt
蘂	anns
藳	aymt
䣮	sgdc
蓗	atfhw
癖	unk
碥	dyna
㯡	swin
迺	spdz
艼	asjn
姻	vld
翧	pgjnt
漰	imee
贽	rvym
颾	mtjj
橻	snff
㒾	jytb
䃨	dxkj
艙	tewk
柛	sjhh
瑮	gssy
䘓	tlqv
榑	sgefe
灄	ibbb
呑	tdkf
㩐	rtff
暘	jjgr
龶	龶
涘	ictd
埿	inxf
㹥	qtygj
逐	epi
㧢	rldy
囊	gkh
惜	najg
葀	artd
岡	mumk
捼	rtvg
攻	at
妚	vgiy
湱	idhd
餍	ddw
劓	thljk
藐	aee
柫	sxjh
趞	fhaj
齠	hbvk
廬	yhale
萡	airf
泷	idx
赣	ujt
瘪	uthx
䜋	ykhm
盖	ugl
望	yneg
汎	imyy
㿰	uqhc
畣	wgklw
歰	vyvhw
诎	ybmhn
䈷	tstk
恵	gmnu
啯	klgy
蟗	gkhju
䝋	epfix
着	udh
踚	khwa
詚	yjgg
朐	eqk
十	fgh
䉫	ttqi
㸔	tuthg
舌	tdd
䐼	edhi
抨	rguh
蝏	jyps
陾	bdmd
硆	dwgkb
乇	tav
盯	hs
䏖	exhh
搖	rqrm
殃	gqm
㮩	sthnw
侞	wvkgw
䄋	pydn
郧	kmb
碃	dgeg
㼝	qbgn
皒	rtrt
虘	haeg
霸	fafd
㑞	woah
攨	rpwye
貫	xfmu
怿	ncfh
锇	qtrtt
邯	afb
倧	wpfi
貵	cdmu
囗	lhng
䕉	alff
蜸	ahnj
腏	ecccg
錅	tqtq
厊	daht
耗	ditn
珐	gfc
䅗	ttvgy
盏	glf
䢴	tdbh
摻	rcce
悁	nkeg
崟	mqf
乓	rgy
䏕	etfg
㧫	rdmj
碠	dyps
潺	inbb
漬	igmy
榯	sjff
诨	ypl
蔐	aumd
䕊	aylg
翸	famn
䄑	pyqj
㺭	gbg
㿭	ryhc
凿	ogu
酾	sggy
傞	wuda
劘	yssjg
䏡	efiy
䢧	nwep
霔	fiyg
趫	fhtk
竾	tbb
邡	ybh
乺	rnrn
浯	igkg
饻	qnye
砈	ddbn
䊍	tqto
跁	khcn
耄	ftxn
焐	ogk
㞿	mfqu
胩	ehh
疛	ufi
翊	ung
啍	kybg
䝱	lllm
嫐	vllv
挢	rtdj
䦾	wnnq
狆	qtkh
圴	fqyy
㚜	dakgo
娤	nhdvm
剓	tqtv
埇	fceh
埧	fhwya
蔩	apgw
畎	ldyw
幩	mhfm
灅	illf
茅	acbt
袞	ukeu
孰	ybvy
鉬	qhgy
䌎	ltki
湹	idjf
䬔	mtjjd
屳	tymj
篕	tfcl
袙	purg
姷	vdego
蔃	axkj
嘈	kgmj
箎	tham
狈	qtmyv
妹	vfi
㹚	trok
湷	idwj
礿	pyqya
烤	oft
菬	aivk
㭌	srhh
㤤	njqy
挝	rfp
䕲	ayyi
秲	tffyl
压	dfy
陏	bdeg
瀯	iook
燩	oryt
鬵	aqah
涮	inm
躡	khbb
胐	ebmhz
璩	ghae
愘	nptk
鐾	nkuqv
紊	yxiu
䄾	tadtp
䥯	qlcx
掹	rblg
㘺	fwat
袘	putb
㕹	kdcyk
樍	sgmy
䗷	jujn
㹘	trfj
䑋	eyke
詀	yhkg
儢	whan
峙	mff
伾	wgig
鄍	pjub
㛵	vemf
荋	admj
牑	thga
蜵	jjggu
鈘	qfcyb
㑵	wutd
裬	puft
敚	ukqt
仫	wtcy
齩	hbuq
㕰	ktfn
窂	pwrh
碦	dptk
餥	djdef
䶑	thlhc
押	rl
瓸	gnyj
璙	gdui
㲤	ykgn
篫	tamr
玪	gwyn
泴	ilfv
矁	hton
穋	tnwe
捤	rntn
圵	fhg
泵	diuy
賙	mmfkl
窒	pwg
㡽	yvfh
慮	haln
儚	walq
䐿	etmd
躷	tmdvd
㛭	vajg
送	udp
镶	qyk
憧	nujf
羝	udq
䕸	alfk
否	gik
嵯	mud
譇	ydfj
蛕	jdeg
財	mftt
䣏	wawb
爞	ojjj
皇	rgf
泌	int
䂏	tdvk
霾	feef
㨞	rgxi
蝽	jdwjg
姐	veg
劺	crhl
侌	wync
薴	apns
搇	rwye
呅	kyy
澅	ivfg
珢	gvey
那	vfb
㕭	ktdy
㒊	wvyh
矾	dmy
苂	aouf
䘶	pubb
菙	atgf
梯	sux
闭	uft
㠑	mlddq
完	pfq
阘	ujndh
喻	kwgj
湓	iwvl
㳅	igiy
蠳	jmmv
䈡	tqrn
碱	ddg
逈	tmkp
咕	kdg
㳳	idqn
忩	wcnu
賕	mfiy
赺	fhwns
䒆	teyt
枧	smqn
鈻	qnhn
訵	ylg
肒	evyyy
嘱	knt
壎	ftgo
㭒	snhn
磫	dtwh
㩉	rwgn
寧	pnls
馇	qns
㕄	dgxi
布	dmh
䇰	tbig
姢	vceg
兮	wgnb
㻢	gytb
䨟	fiff
䧋	bhqn
礼	pynn
蕓	affc
況	ikqn
植	sfhg
䄙	pypu
鋑	qcwt
䀁	delf
拐	rkl
㹯	qtws
洁	ifk
劚	niljk
犑	trhd
諭	ywgjt
瓥	rcyj
龴	龴
㙁	ftxum
姈	vwycj
員	kmu
䪭	ujuj
跉	khwc
竎	uaj
㮸	sudp
艽	avb
汕	imh
嶜	maqj
䯧	ypmk
诊	ywe
秔	tymn
䉤	tovt
㑩	wlqy
妙	vit
彈	xkkfo
靟	djdno
狵	qtde
厴	djel
炎	oo
俊	wcw
䛑	yntt
㿱	rrhc
萆	art
伄	wxhh
珶	guxt
丅	ghk
搠	rub
吵	ki
䥕	qumt
詉	yvcy
䙖	pume
䕽	akhj
笷	tqtb
妔	vymn
檖	suep
膝	esw
阌	uepc
川	kthhf
委	tv
藻	aik
䙳	sou
鄄	sfb
鎿	qwgr
猛	qtbl
泍	isgga
懦	nfdj
䍊	rmuq
䵡	gdlo
跴	khsgf
柺	skln
脄	edoy
㚈	qfhu
㿨	rdthe
衦	pufhw
蜶	jywf
趩	fhlw
秠	tgig
寕	pdls
掦	rjqr
䎺	brmj
㜼	vllg
夞	qhkx
笟	trcy
䔕	aegy
瓺	dgnnk
䣦	sgln
曡	jjjgv
弶	xyiy
鏬	qhah
獨	qtlj
㺝	qtal
酻	sgeb
柮	sbmh
圐	llyv
㵝	iyek
蓻	afuy
䟷	khrr
膊	egef
䤧	qlkgb
㣚	tmgkh
炳	ogm
鞑	afdp
畺	glgg
彗	dhdv
阓	ukhmn
殕	gquk
礏	dogw
串	kkh
嵭	mupy
恁	wtfn
娥	vtr
垑	fqqy
嗠	ebtk
汢	ifg
樏	slxi
拧	rps
腻	eaf
粁	otfhf
㭹	sxyx
猫	qtall
漨	itdp
心	ny
䦈	ddag
䖁	ajmn
聏	bdmjl
塜	fpfe
㗠	vckx
媛	vefc
矿	dyt
垍	fthg
誇	ydfn
莿	agmjp
鏢	qsfi
瞌	hfclp
䂈	cbtjk
砟	dth
緳	ydhi
嬺	vaan
瓩	gnyfl
衩	puc
洪	iaw
憬	njy
柖	svkg
㙝	flle
棌	sesyv
鬟	del
㲭	ooon
柈	sufh
態	cexn
痍	ugxw
珁	ggnn
疝	umkp
毯	tfno
堤	fjgh
請	ygeg
蜺	jvqn
娳	vtjh
外	qh
䤶	qdjne
蚠	wvju
穘	tffqe
湐	isrg
穩	tean
㩫	rrrm
䠅	khlt
飨	xtw
䟉	fhlj
湅	igli
噄	kdhi
邊	thppr
摥	rtjr
碧	grd
瀜	igkjy
蘞	awgt
盬	ahnlr
儫	wype
锾	qefc
㬂	jjmy
妧	vfqn
阋	uvq
缔	xup
鐖	qxxt
㳦	iaah
䧩	bnbt
斉	yjf
脼	egmy
坈	fpmnq
㠐	mtdk
腋	eywy
漗	itln
旄	yttn
杢	safm
穟	tuep
螧	jftjq
䣞	kkub
釽	qrhy
務	cbtl
憖	swwnh
鈜	qdcy
腢	ejmy
㣝	tadt
壚	fhal
㪙	jsty
巭	alfw
汒	iynn
炐	odhh
譃	yhag
㷅	bcou
馊	qnvc
㳢	itdje
豦	haei
㕎	dfcl
墮	bdaf
坪	fgu
糲	oday
翡	djdn
潆	iapi
氟	rnx
夒	dhht
箽	ttgf
䠥	khutx
靰	afgqm
彊	xglg
医	atd
磾	dkkf
乚	nnll
猿	qtfe
睚	hd
葱	aqrn
蝵	toju
叀	gjhc
歽	gqrh
譶	yyyf
䆏	tolw
浦	igey
甅	gnyfy
谋	yaf
譚	ysjh
㼰	rtfnt
濧	iogf
贾	smut
㑨	wktd
豾	eeggx
妺	vgsy
疊	lllgp
灇	iogc
眡	hqay
饏	nbte
琱	gmfk
榰	sftj
脷	etjh
覿	flmq
㣉	aett
㲥	yvhnp
岜	mcb
塊	frqc
䣻	sgwkb
㷆	ownf
矮	tdtv
蓑	ayk
訶	yskg
洣	ioy
迻	qqpi
䄫	tnn
鞴	afae
恅	nftx
笡	tegf
恗	ndfn
屘	ntfb
闺	uffdu
绌	xbm
座	yww
侶	wktk
倡	wjjg
站	uh
牒	thgs
嬦	vfnf
桒	fasup
吸	ke
犕	trae
惆	nmf
䉂	tlxi
㾋	uwsi
划	aj
盱	hgf
飂	mtjee
龩	龩
亴	ypfv
䓘	athk
硂	dwgg
馍	qnad
䐋	ewcn
倅	wywf
淝	iec
鐹	qmnp
钰	qgyya
䂆	cbtyz
襝	puww
瓄	gflm
耮	diol
忋	nnn
阅	uuk
艎	terg
瓬	ygnn
裶	pudd
桔	sfk
厘	djfd
槀	ymksv
㵥	ipnl
挈	dhvr
䛔	ydmj
苾	antr
㗉	dhvk
入	ty
㳋	irggs
㹜	ddyj
膓	etjr
瀐	ifag
剐	kmwj
雹	fqn
副	gkl
芌	afnb
砘	dgb
倍	wuk
胼	eua
乼	iygn
算	tha
峴	mhqn
㞔	nqqi
薒	ahqo
钜	qan
壱	fpxb
儘	wvhl
渏	idsk
陰	bwyc
袠	yrwe
鉍	qntt
鞐	afhh
啊	kb
褔	pugl
銁	qqjg
茌	awff
㸢	thge
蜆	jhqnw
鏍	qlxi
抏	rfqn
啺	kjgr
聚	bct
杛	sxnd
椢	slgy
䏩	ewgk
礳	dysdo
険	bwgw
澞	ihad
剼	cccjw
疒	uygg
咎	thk
侘	wpta
吝	ykf
冬	tuu
拗	rxl
䚅	swwqr
饧	qnnr
䆄	tylgm
㨏	rmdo
冾	uwgk
昽	jdxn
䶮	dxgd
虝	hamr
黪	lfoev
㖜	ykxb
挕	rbg
砇	dyy
㞦	mmn
矫	tdtj
㺰	ggmh
䎂	nqnng
㛩	vyce
㦌	tfnnp
硥	ddne
䥒	xkjq
榃	sslf
脚	efcb
敂	qkty
绻	xudb
朌	ewvn
㿖	uhal
䗝	pyjj
㖗	kmwn
毓	txgq
宯	pftb
㤳	ngik
俶	whic
䞿	pfjh
辜	duj
肉	mww
爚	owga
引	xh
㛉	vsg
鬔	detp
舵	tepx
帛	rmh
躹	tmdo
榨	spw
拕	rpxn
治	ick
跔	khqk
㩹	rllgb
勾	qci
沞	igmh
謡	yerm
晴	jge
覅	svqr
槄	sevgd
琈	gebg
㐆	rvnv
罁	rmmm
坍	fmyg
捱	rdffw
㐳	wgqn
熇	oymk
䵨	lfoem
㢶	xdjgb
䇵	tirj
誴	ypfi
稃	tebg
銣	qvkgg
琖	gaat
毽	tfnp
㟒	mvtks
䛪	ypwx
䜧	yvyhd
栏	suf
㑂	wgmw
闲	usi
虃	aiwg
浏	iyjh
豞	eqkg
䒕	aiub
渞	iuth
粰	oebgi
褋	puas
鋗	qkeg
煌	or
藲	asak
茹	avk
蚭	jnxn
笞	tck
婪	ssv
㿶	upyc
㗁	kkknj
㴅	ilwk
钉	qs
詈	lyf
䁻	hxrs
貯	mpsh
分	wv
瀎	ialt
咲	kudy
罱	lfm
価	wsgk
瓼	gnyf
蚚	jrhh
錃	ihcq
餐	hq
黁	yssjz
墐	fakg
䍮	udiq
割	pdhj
枉	sgg
识	ykw
褍	pumj
㪭	halc
遒	usgp
㕐	dvqod
㔋	ahnjs
錒	qbsk
䗪	yaoj
犴	qtfhy
滇	ifhw
怎	thfn
㩤	rget
㤇	ntdy
观	cm
鋥	qkgg
涝	iap
諾	yadk
矺	dtan
㖋	wjkx
瘹	uqqy
佦	wdgs
㭙	sffy
痡	ugey
硹	dswc
穉	tnihr
笑	ttd
薸	aisi
㝧	pvwf
畽	ltgf
升	tak
芓	abfr
臮	thwu
澤	ilff
檢	swgw
懵	nal
胢	eskg
耊	ftgfv
沍	igxg
霧	fcbl
㭓	scah
㔶	aujm
䣡	ugtb
臣	ahn
㞌	nbd
惔	nooy
梉	snhfj
苔	ack
楄	syna
啑	kgvh
梸	stjh
孯	ahnb
髺	detd
䁭	hddd
糸	xiu
痳	ussi
㤭	ntdj
岞	mthf
沐	isy
㪡	pdhci
俩	wgm
㘨	fmwy
嫹	vamw
濍	iaqn
恹	nddy
蔨	alub
嫟	vaak
崀	myver
矶	dmn
灥	riri
峤	mtdj
栧	sjxt
褦	pucx
唍	kpfq
剮	mnmj
刕	vvvb
勞	oopl
儩	wmjr
团	lft
墎	fybbj
犷	qtyt
㤨	nawy
溥	igef
䄎	pydk
穤	tfdj
果	js
厦	ddh
詊	yufh
瀒	iswk
㫖	hjf
祥	pyu
聶	bbbfn
㭧	tesu
吁	kgfh
靐	flfl
嗧	lkwa
朓	eiqnf
䘑	tlyi
䆝	pwtl
髜	ymka
需	fdm
欛	sfae
犖	ooph
䪇	afafp
鑓	qkhp
慅	ncyj
睃	hcw
黜	lfomu
仸	wtdy
㹱	qtkhg
痺	urtf
菖	ajjf
娽	vviy
序	ycb
绋	xxj
鎐	qermw
䓛	anbm
愂	fpbn
贞	hm
釿	qrh
沽	idgl
竴	uusf
硻	ahnd
缘	xxe
㵊	ijbc
囚	lwi
盁	elfr
彳	ttth
隃	bwgj
㫋	ytmf
䁨	hybb
醖	sgjl
㣨	tvdg
岤	mpwy
㔦	udyl
檍	sujn
咙	kdx
彍	xyawl
褅	puuh
䩘	afgx
虻	jyn
欇	sbbb
芝	ap
匐	qgk
妜	vnwyl
栁	sqbht
帒	wamh
悠	whtnu
萜	amhk
濭	iafl
婩	vmdf
㿟	rrg
蹝	khthf
掯	rheg
㱑	hque
髡	degq
暔	jfmf
衮	uceu
廃	ywfq
㬲	gjql
瑨	ggoj
䢦	yxip
最	jb
礧	dlll
桃	siq
㫽	jviy
唣	kra
歧	hfc
蓄	ayx
䦽	bcbh
蠂	jaas
谆	yybgc
旫	jvna
能	ce
䃄	dyiyc
竗	uitt
竃	pwfn
壳	fpm
奿	vyvd
䀂	pvlf
㭱	salh
邭	qkbh
傹	wujq
僾	wept
譸	yfnf
䔒	abuk
莖	agva
崗	mmum
樗	sffn
胨	eai
卉	faj
翢	mfkn
拓	rd
厠	dmjkg
鉙	qkwy
陲	btgft
稾	ymkt
荸	afpb
㘒	ttgx
鉏	qeggr
莢	adwwz
芷	ahfr
筴	tdwwv
剫	yacj
䉝	tugt
石	dgtg
烐	otey
蟲	jjju
邫	dtkc
広	yci
褬	pucs
儀	wugt
蕖	aias
䏐	enwy
春	dw
嘷	kthfv
瓅	gxrs
荃	awgf
趕	fhjf
㽤	lqoy
䠙	khuy
匠	ar
瘞	udwf
䈣	tght
娑	iitv
禅	pyuf
活	itd
䩡	afdw
愍	natn
䰁	devi
僈	wjlc
仱	wwynd
㒀	wumd
咩	kud
珏	ggy
嫫	vajd
屠	nft
糧	ojgf
錘	qtgfm
䆆	tkks
䀆	vhgl
熪	otqq
踧	khhcy
㺙	qtpmf
熟	ybv
捘	rcwt
滿	iamy
翇	ndcu
豧	egeye
缁	xvl
悰	npfi
孖	bbgk
傼	wakw
螬	jgmj
殂	gqe
祬	pygfu
楗	svfp
侉	wdf
燠	otm
炕	oym
鋩	qaynx
渧	iuph
㦎	nvfg
庬	ydne
蝯	jefc
鏾	qaet
撵	rfwlh
惘	nmu
皤	rtol
跊	khfi
拦	ruf
珉	gna
伏	wdyg
瀡	ibdp
払	rcyd
鈔	qitt
㫪	dwhj
腒	endg
㵼	ipvou
貇	eeve
灴	oagj
氜	rnjf
苺	axgu
栕	sahh
䚶	ygdy
耸	wwb
笒	twyn
干	fggh
己	nng
㜚	vpwj
茠	awsu
趬	fhfq
昁	jgmh
㦻	nrat
仯	witt
㠺	mhit
聣	bvqn
钬	qoy
渊	ito
堹	ftgf
羊	udj
䨎	fxcu
㬓	jsfi
荻	aqto
萍	aigh
䕈	anhs
衝	ttgh
䤱	qmrh
㩨	rdhn
豝	ecn
瘋	umtjr
䐦	efcl
蛰	rvyj
枛	srhy
㖺	kdwj
德	tfl
䤈	sgwl
悌	nux
㯣	saws
貣	amu
荣	aps
蹑	khb
信	wy
桴	seb
㓾	nirj
廆	yrqcr
䆱	pwio
呥	kmfg
趨	fhqt
谪	yum
㭦	spta
猈	qtrfx
瀉	ipvo
蝅	gdgj
洤	iwgg
匤	agyi
讠	yynv
恊	nlll
䩀	djdmi
渆	iuaj
傯	wtln
职	bk
灮	oqb
婯	gmyv
者	ftj
壤	fyk
侜	wtey
䉄	tbft
䋇	xnyy
熏	tgl
惏	nssyt
趓	fhms
异	najl
揈	rqygk
莌	aukq
渝	iwgjt
晫	jhjh
㻚	geeg
㨙	rexd
燮	oyo
疭	uwwi
岳	rgm
葁	augv
叵	akdg
僥	wffq
蹾	khyt
梤	smwv
泮	iuf
霹	fnk
锦	qrm
艊	terh
灣	ixyx
汀	ish
劀	cbtjt
胹	edmj
衬	puf
儙	wkhp
詨	yuqy
㤦	ngkq
婗	vvqn
瓵	ckgn
法	if
芑	anbq
隤	bkhmh
汲	iey
㺂	qtdt
䤿	qdhr
劣	itl
楧	samd
遀	daep
硍	dvey
悋	nykg
蛷	jfiy
兞	dqtn
霂	fisu
萟	atvy
汽	irn
䄳	thgu
崧	msw
录	vi
討	yfy
㸬	trgh
積	tgmy
傁	wvhc
療	udui
蒲	aigy
敋	tkty
畧	ltkf
疹	uwe
嫄	vdri
睇	huxt
藵	awke
龪	龪
㚐	dduf
嗬	kawk
䔂	apuj
溧	issyn
䵃	swwwl
磻	dtol
豮	efamd
屟	nans
湨	ihdy
牡	trfg
飄	sfijs
剜	pqbji
㙐	fmdj
煗	odmd
苜	ahfd
楥	sefc
竔	utah
篝	tfjf
䖢	jitt
袁	fke
曝	jja
炛	owxb
懾	nbbb
彖	xeu
峮	mvtk
硘	dlkg
箓	tviu
唱	kjj
錹	qheg
仴	weg
峬	mgeym
绳	xkjnp
賊	madt
雷	flfd
躟	khye
筤	tyve
藛	apvo
㝡	pbcu
㳷	iqrj
蛭	jgc
暕	jgli
㨋	rftju
听	kr
妢	vwvn
庋	yfc
素	gxi
啬	fulk
懞	nape
㼗	sgnn
嗿	kwym
㹽	qtaa
礒	dugtj
噯	kept
柷	skqn
㞸	mgiu
纼	xxhhs
檽	sfdj
艒	tejh
齀	thln
筈	ttdf
鏗	qahfl
唨	kbeg
妅	vag
貈	eete
嬏	vtol
㲴	rnkh
殮	gqww
旧	hj
彎	xyxx
裝	nhdej
祽	pyyf
羗	udnc
黢	lfot
味	kfi
幞	mho
虞	hak
锜	qdskq
於	ywu
朁	aqajf
㥽	ngmy
㚰	vgig
䔁	assuw
裸	pujs
伨	wqug
話	ytdg
嵹	mxkj
荤	apljy
㭈	snwyz
逪	ajpd
䗐	ytbj
博	fge
㥈	mhhn
嵃	mute
苚	aej
弇	wgka
喟	kle
苍	awb
弔	xhk
㼄	gxxl
珥	gbga
䒴	adefe
别	klj
蟜	jtdkp
䝳	hqcm
䊟	oamy
嫅	vuda
遊	ytbp
牄	nhdkb
彛	vowa
擝	rjel
誌	yfny
䨜	feefl
菣	aahc
廜	ynfj
刧	fcvn
焏	bkco
眮	hmgk
守	pf
嘼	kklk
蚰	jmg
筗	twkhc
祱	pyuq
芄	avy
窋	pwbm
㼪	dwwnh
㓐	ufwf
乙	nnl
糵	awno
炣	oskg
穈	ysst
謥	ytln
兓	aqaq
簺	tpff
䰃	deug
䁅	hblg
谑	yha
㵔	idfj
崎	mds
殑	gqdq
隀	btgf
夑	oyot
惰	nda
忥	rnnu
㿲	dskc
㬩	jdhn
満	iamm
遼	dujp
䟠	khat
铌	qnx
鉡	qufh
襁	pux
扁	ynma
㚻	lvf
䔙	aqqy
䟄	fhgm
筞	tpsu
滎	oopid
啇	umdf
塺	yssf
搲	rpwyg
䓡	atdk
㽴	udyi
掇	rcc
糖	oyvk
檼	sean
㔀	jyij
胅	erwy
椒	shi
㴧	ithns
讲	yfj
﨨	qfuf
揬	rpwd
歺	hqu
出	bm
獟	qtfqj
鍨	qwgd
温	ijl
跌	khr
梣	smwn
䩖	afit
䶡	hbmj
専	gmfu
岷	mna
虗	harg
䎮	diud
氙	rnm
瀇	iyaw
焥	opqb
䟎	fhfm
栺	sxjg
啪	krr
塉	fiwe
萂	atkf
㐭	ylkf
牞	trln
冊	mak
测	imj
侄	wgcf
膣	epwf
鞉	afiq
鋒	qtdh
鉲	qhhyc
獴	qtae
䊪	oajyh
嵳	muda
䢙	mpi
㻆	gceg
査	segf
㬒	jada
䯫	jyik
芚	agbn
彰	uje
㫤	jyni
珓	guqy
㶬	ogsy
旜	ytyg
啗	kqvg
䙛	puueh
昗	juu
峡	mgu
偺	wthj
筐	tag
馁	qne
坲	fxjh
碂	dpfi
偣	wujg
䥀	qbhj
弄	gaj
柯	ssk
㙳	fdgn
涕	iuxt
䪂	afgi
瞢	alphe
誣	yawwk
蛲	jatq
碤	damd
㵛	iudk
撦	rdfja
焧	owcn
懲	tmgn
䣱	sgqky
彨	gmye
乴	rrnb
䔅	askk
祮	pyfkb
質	rrmu
椑	srtf
犗	trpk
葘	agvl
彋	xlgek
䔄	aerm
箁	tukf
汍	ivyy
喏	kadk
惕	njq
䥤	qfqnf
莞	apfq
摠	rtln
系	txi
硌	dtk
酩	sgqk
硜	dgva
幙	mhadf
秜	tnxn
竟	ujq
奫	dijg
樣	sugi
㐔	ynb
䅀	tgqj
邀	rytp
㤓	nsgg
盭	xful
阴	be
桗	sesy
㩰	raks
齪	hbkh
芗	axt
㰑	snns
蝐	jjhg
弼	xdj
瑊	gdgtu
爸	wqc
屚	nfid
㟨	mmdj
䛨	yuh
匡	agdj
民	n
栢	sdjg
飺	hxwe
昹	jynis
䫺	dcmj
菶	adwh
嶫	mogw
㦞	fnan
㠠	mhal
禚	pyuo
狊	hdu
瞭	hdui
脢	etxu
渄	idjd
㫬	jqjgz
徊	tlk
痜	utmv
噆	kaqj
㱔	hxqu
陞	btaf
㢓	yujk
秐	tfcyx
枕	spq
硑	duah
㸾	trvn
袄	put
忊	nsh
摰	fwfr
譠	yylg
睒	hooy
䧏	btdh
㡯	ytav
圝	lxyx
吮	kcq
腉	evqn
斓	yugik
㸏	yssol
拘	rqk
犂	tqth
忬	ncbh
悭	njc
啥	kwfk
䅩	tfcw
嬷	vys
曈	jujf
褛	puo
棨	ynts
㖇	kdmj
毤	wcqn
昈	jynt
㛫	vjqr
疓	uev
㗎	klks
掕	rfwt
㡾	yvei
秮	tckg
窕	pwi
尨	dnee
烘	oaw
睕	hpqb
儖	wahl
腠	edw
㿹	hcfp
擺	rlcx
䭪	qnjf
䄴	teg
貰	anmu
蔵	adat
眭	hff
滳	iumk
茡	apbf
諹	yjgr
奖	uqd
䤆	sgwd
栒	sqjg
藟	alll
憃	dwvnn
婧	vge
㑐	whiy
糒	oate
愑	ncel
苠	ana
購	mfjf
䨾	ydjdv
䧅	bgxw
䰞	xfth
䁱	hffq
厓	dffd
竢	uctd
菴	adjn
耒	dii
醵	sghe
籛	tqaa
芭	ac
䓾	aiiv
豕	egt
梺	ssgh
㛈	vftn
嚆	kay
揂	rusg
䖡	jnfg
㶷	oqjg
饥	qnm
娏	vdne
汾	iwv
㣧	txen
就	yi
㖿	kbbh
噃	ktol
煱	omnk
罦	lebf
㖔	kgdk
㦘	rytn
筒	tmgkk
墍	rxaf
邚	vbh
䞎	mjjg
㝤	pfjfs
曚	jape
䵘	twir
浕	inyu
䧚	bymk
艈	teyqd
瞞	hamyz
隄	bjgh
楃	sngf
璧	nkuys
炾	okqn
蟓	jqj
折	rr
菋	akfi
譗	ytwk
澆	iffq
锛	qdf
昅	jeyy
殐	gqgi
暬	fwfj
费	xjm
凚	ussic
鍚	qjgr
㮒	ssfg
䰕	dehl
蒊	awxx
嬧	vvhl
凰	mrg
昚	dujf
拑	rafg
悜	nkgg
曓	jbmf
洄	ilk
荗	adyt
嶧	mlff
昣	jwet
㑁	wbmh
獿	qtdtv
䌻	xng
諜	yans
矲	tdlx
葊	awgac
肚	efg
㠧	mysd
㷥	oobg
䙭	puph
隅	bjm
寮	pduc
㻍	gkgd
娉	vmgn
龚	dxa
䑠	tebh
涛	idt
薥	alqj
睔	hwga
䨿	gddd
䝿	vwmu
沌	igb
癸	wgd
扚	rqyy
㥌	nqoy
泭	iwfy
蜤	srju
虩	ijim
䅈	udtu
嘌	ksf
䙒	puyle
㴃	iynip
㖼	kafs
蹌	khwk
㝻	akgtk
娴	vus
㧾	rqrnw
䏂	bvhc
蓨	awhet
仾	wgxg
罺	lvjs
玂	qtar
㲒	qktn
珨	gwgk
釮	qftt
婤	vmfk
凧	mmhk
覷	haoq
䀌	vfdl
巈	mafo
橩	soof
䝠	eedi
㦐	nafm
耈	ftxka
玤	gdhh
䜉	yswi
䍹	udtd
襒	puut
芯	anu
瑔	griy
㡅	mhqq
㨣	rwcn
銪	qdegk
洅	igmf
㛁	vguh
熧	twwo
藥	axrs
羃	lajh
㣗	tynt
氪	rndq
䚺	ytyd
锂	qjf
圞	lxys
筄	tiqb
禭	pyup
䔌	arsg
塋	oopfg
衯	puwv
邃	pwup
卥	hlry
㔈	adjj
溼	igxf
屇	nld
櫼	swwg
蠚	adkj
䶢	hbdt
馩	tjfm
猶	qtug
箉	trkl
䅕	tndg
鑶	qadtl
蒐	arqc
纵	xww
蚺	jmf
妟	jvf
碵	dhmy
糃	ojgr
毣	ntfn
芦	aynr
䶗	hbsk
貕	eeed
览	jtyqd
抮	rwet
剗	aajh
虸	jbg
敫	rytyg
裙	puvkx
襚	puup
垆	fhnt
䂢	dtuy
尮	dnes
廈	ydht
如	vk
盝	vilf
瓛	ghad
萕	ayjf
㦷	ceat
䇭	tftx
攄	rhan
怕	nr
㙺	fakm
弗	xjk
艹	aghhn
皐	rifj
蜭	jqvg
㖕	kuhm
臝	ynkyx
偋	wnua
狥	qtqj
厽	cccu
憌	qqun
㬯	jyny
䝶	myiy
㠿	hxmh
岻	mqaym
巁	mday
葾	aqbn
韁	afgg
呯	kguh
燺	oyms
㦆	nhahh
䤂	sgas
癝	uyli
茼	amg
陠	bgey
珺	gvtk
犱	qtvy
粲	hqcoa
丯	ehk
䝝	eedk
䁐	hamd
倫	wwga
枰	sgu
䓢	aldf
䟚	khfj
禒	pyxe
岑	mwynz
囈	kafc
㧦	rqjg
踰	khwj
説	yukq
揝	rthj
瓦	gny
枅	sgah
嘤	kmm
抣	rqug
㻬	gffn
芋	agf
昙	jfcu
瑝	grgg
㷲	otgl
㹃	djdh
鉊	qvkg
鍬	qtoy
䶧	hbfq
滫	iwhe
璶	gvhl
怒	vcn
猅	qtdd
砫	dygg
黎	tqt
嫋	vxuu
㥔	nyce
罧	lssu
瀠	iooim
䰜	xgkx
䃇	drmh
㬧	jbmi
雰	fwvb
唸	kwyn
嫍	vevg
峚	mdffg
䀘	hgah
眲	hbg
䐀	edsk
椞	srsu
㜎	vexd
罥	lkef
砵	dsgg
䤙	sgxj
徾	tmyt
杉	set
㬴	eawy
䅴	tfpi
䵲	lfos
勌	udbl
礽	pyen
㪆	qayc
䢻	ahnbz
䂾	dsww
㠔	mnku
桩	syf
橥	qtfs
䗖	jgkhv
愥	namd
䏻	cefc
疉	lllg
翨	njghf
䎄	vkng
㔵	annw
䅑	tevg
㡄	mhqj
栱	sawy
筠	tfqu
䆡	pwye
㤵	btnu
讬	ytand
腈	egeg
䵇	ysstq
䬒	mtjci
私	tcy
㯲	sssi
协	fl
惻	nmjh
櫝	sflm
䵀	swwmr
鞇	afld
㖉	kwhg
羉	lxyi
柊	stuy
眨	htp
咰	kqjg
㶹	oaiy
䪩	ujwn
㛡	vpfq
娱	vkgd
垿	fycb
㡁	mhdnc
擶	rtuj
䞙	fhgh
㴚	iuey
対	yfys
鋜	qkhy
瀱	ildj
鄴	ogub
楣	snh
甪	tek
苣	aan
䂶	dfclz
艱	akfe
㭫	swwfj
揶	rbb
扵	rwuy
胗	ewe
勬	udxl
邘	gfbh
筷	tnnj
衐	tanh
樈	sujq
䙊	pugh
焂	whtoz
嬸	vptl
㳕	iufg
阚	unb
厭	djed
墻	ffwk
蓚	awhe
橡	sqj
䞬	fhte
㼹	aynnc
蝗	jr
硸	dmdf
㨵	ruev
㖬	kvcy
䖂	axyr
㼋	drcy
䩭	afdk
克	dq
毪	tfnh
洬	imgq
艆	teye
鍩	qadk
猺	qtem
嚚	kkaki
仪	wyq
䈊	tfwt
睬	hes
嵤	oopmn
㵟	itmt
㑈	waiy
養	udye
戻	yndi
跬	khffb
䉙	tffc
拹	rlll
峣	matq
挩	rwkq
䯳	dewc
錁	qjsy
朑	eann
啧	kgm
䄱	tyn
䧟	bevgt
䥘	qwwj
诬	yaw
具	hw
箄	trtfe
篸	tcce
狚	qtjgm
斸	nilr
錢	qaat
裪	puqm
㖩	kbcy
踢	khj
㤺	nynq
卺	bigb
䗄	jwqr
沏	iav
帐	mht
帉	mhwv
釸	qqya
㱮	gqkmp
岺	mwyc
鈳	qskg
㸭	trcn
恎	ngcf
嘚	ktjf
墸	fafj
䓵	akkkc
㚺	vebgk
秒	ti
翆	nvfj
煽	oynn
醁	sgvi
墌	fyao
饪	qntf
聂	bcc
刓	fqjh
蒻	axuu
䧄	btkg
矴	dsh
抡	rwx
肓	ynef
菡	abib
许	ytf
㐓	sknb
鎓	qwcn
㘘	xyxk
橴	shxi
䒙	ahf
㮐	sith
䏇	bsfik
嫳	umivw
㽣	lakg
溸	igxi
嫩	vgk
嗮	kjsg
䅒	tayn
韮	adjg
㝑	pyb
諳	yujg
蹲	khufr
珍	gw
姜	ugv
㽑	afsf
菸	aywu
峂	mtuy
傭	wyvhm
䏃	bpju
痦	ugkdj
夸	dfn
䅸	tauh
礆	dwgw
揞	rujg
蛡	jng
䕃	abwd
刢	wycj
港	iawn
皲	plh
妞	vnf
鏡	qujq
奺	vqyy
蓅	aiyq
嵘	maps
㫭	jffu
喘	kmd
㜥	vlmy
䩽	afak
躆	khhe
铊	qpx
環	glge
秓	tfcy
辧	uvuh
蕈	asj
诶	yct
砷	djh
壊	ffle
莥	aqtfj
䖫	jwfh
拷	rft
菚	aaar
濖	ilfj
㨼	ltkr
㩌	rxjm
簬	tkhk
磽	dffq
䌷	xmg
㪗	ukhc
蚋	jmw
佫	wtkgo
死	gqx
榏	suwl
徒	tfhy
䧡	byvh
噬	kta
㮇	sgdn
姪	vgcf
蓿	apwj
狜	qtdgh
琝	gjyy
盢	ldlf
砾	dqi
䒑	uytg
㦮	dnyt
漑	irxq
虐	haa
䞼	fhxe
㞟	nusd
汑	itan
塁	liff
襆	puoy
炸	oth
䗣	afjj
湣	inaj
惑	akgn
两	gmww
畨	olf
鎪	qvhc
賩	mpfi
鬺	gkmr
㭃	sxy
揣	rmd
㲫	ogun
㐢	iebna
箬	tadk
薁	atmd
髣	deyb
椸	sytb
嘁	kdht
㬪	jjjgr
㢐	ymnk
隔	bgk
呓	kan
菒	ajsu
㛔	vtdh
涽	iqaj
㙎	fdgt
杷	scn
跒	khsk
藏	adntx
㲟	amdn
䇅	uat
圥	fqb
嗩	kimy
鑤	qjai
健	wvf
膆	egxi
謵	ynrg
䉛	ttmd
㟘	mmfkv
熛	osfi
车	lg
陇	bdx
琴	ggw
渚	ift
剥	vijh
瓤	ykky
䉦	tsdp
垯	fdpy
㴜	iyna
亣	yjje
锫	qukg
諘	ygeyl
䉓	tsjs
噳	khade
昀	jqu
㒮	fqei
慐	amnu
㴂	iamf
祚	pyt
躔	khyfi
論	ywgaw
蝹	jjlgh
蹴	khyn
二	fg
鎅	qlwj
话	ytd
聀	bat
徱	tsfie
㣅	xaqj
㗯	ftjx
䧌	bevg
芕	aqu
颶	mtjwh
烇	owgg
渳	ixbg
菌	alt
戝	mat
䃘	dahf
㕛	ccu
郌	ffkc
嚔	kfph
牾	trgk
碜	dcd
琡	ghic
搭	rawk
㔓	tflny
眵	hqq
澈	iyct
刅	vwio
斏	yyveh
焱	ooou
锲	qdh
婀	vbs
蝝	jxey
䆘	pwlj
邞	fwbh
粍	otfn
㳯	iuh
瘦	uvh
郴	ssb
踙	khbc
囵	lwxv
䆽	pwhe
䏵	edne
璲	guep
犬	dgty
㹵	qtga
㟠	mmumd
嬡	vept
㯜	sayf
熻	owgn
收	nh
獻	hagd
䀫	hwgk
獋	qttf
鋫	tjqf
䓔	aftb
偞	wans
㑕	wmqy
挠	ratq
鉠	qmdy
耡	diel
跧	khwg
䏺	etdh
崵	mjgr
䀥	hqiy
檦	ssfj
墵	fffc
伅	wgbn
保	wk
㲙	tfnql
㶏	iben
攴	hcu
䬑	mtjef
覘	hkhq
栘	sqqy
虂	afkko
措	raj
恢	ndo
艰	cv
电	jn
翃	dcng
砗	dlh
䞐	mdwj
孅	vwwg
豙	ueur
楏	sdffs
賃	wtfm
广	yygt
州	ytyh
珼	gmy
爋	otgo
燊	ooost
旃	ytmy
熊	cexob
纤	xtf
刂	jhh
遷	sdnp
牘	thgm
痖	ugog
㧙	rntt
煻	oyvkd
鏁	qvjs
泪	ihgv
匢	aqre
蟅	jyao
促	wkh
蒷	akmu
渵	ialg
戭	pgma
㻻	gybt
谍	yan
梆	sdt
鐊	qbjr
莩	aebf
㚷	vwiy
慫	twwn
秂	twu
䠤	khkf
薆	aept
垸	fpf
暆	jytbm
赂	mtk
㝐	pwcu
皶	sjgc
轵	lkw
晥	jpfqh
躴	tmde
䖓	bmhm
壵	ffffd
奦	cbtd
烆	otfh
赴	fhh
彶	teyy
䜨	ykknw
屻	mvyy
㾥	uhic
员	km
䖖	haml
㯌	sepy
欘	snij
皁	rfj
馃	qnjs
怊	nvk
㤐	hknu
錞	qybg
筯	tegl
壥	fdlf
䯿	deyf
劈	nkuv
㵄	iakd
呮	kkwy
㟯	mptk
湭	iusg
䀙	havn
䝧	mqug
窍	pwan
褷	puthe
㤡	ngqj
拙	rbm
㗌	kpgf
㣖	tdyy
戫	deag
㗗	klrf
潄	igkt
咅	ukf
蓕	asff
䘋	jwwg
撤	ryc
撈	rool
靾	afan
朢	ahng
詸	yoy
拏	vcrj
傈	wss
㮈	sdfi
楽	risu
睡	ht
互	gx
㮥	scdl
綮	ynti
禊	pydd
㫀	jjrh
䞊	mhah
边	lp
齥	hbjx
䝗	eesyk
嚖	kdhn
眒	hjhh
篰	tukb
㞠	nduid
㪘	wgkt
㗭	kton
誺	yswwg
僽	wtonr
䎑	nviy
稨	tyna
瀑	ija
姲	vpvg
玠	gwjh
坙	gvff
梈	sybh
稽	tdnj
畍	lwjh
䈛	thmc
棹	shj
杗	ynsu
榺	euds
帡	mhua
爃	ooos
柿	symh
䩲	afyc
喐	kdeb
挪	rvf
猻	qtbie
㸒	etff
槽	sgmj
䞁	majv
靼	afjg
惢	nnnu
淈	inbm
泝	iryy
䰇	defjr
拽	rjx
揳	rdhd
琔	gpgh
圢	fsh
珆	gckg
阼	bth
赔	muk
痃	uyx
嬙	vfwk
㔌	bctj
蓏	arcy
釾	qaht
柵	smah
瑁	gjhg
趸	dnk
正	ghd
垜	fesy
拚	rca
眴	hqjg
烢	opta
渌	ivi
釉	tom
䣐	amdb
碞	kkkd
㼼	sfinq
贶	mkq
掮	ryne
䔼	avyh
弢	xbhc
䵓	twih
噮	klge
桹	syvef
㽉	ahnns
謭	yuev
璗	ijgy
谄	yqv
屧	ntas
鍽	qyna
䏬	ecrh
䊰	oyfj
㚤	vay
鉢	qsgg
锯	qnd
錛	qdfa
㻋	ggki
䒟	amyfp
㘤	lijg
攓	rpfh
爕	oyoo
裃	puhh
㡵	ywycr
藖	aahmi
坟	fy
賋	muqy
㳻	iajg
觎	wgeq
隯	bfnf
濄	imnp
聑	bbgx
酞	sgdyp
豪	ypeu
侤	wftn
埙	fkmyq
救	fiyt
份	wwv
襋	pugi
捂	rgkg
檸	spns
唜	gskx
㵀	iytd
瓡	fufy
䄦	tbh
㔆	aqaj
棛	syce
㱛	gqgq
汫	ifjh
櫜	gkhsv
沰	idg
嶸	moos
㯵	satf
蟑	jujhr
奀	gidu
䇚	twhu
疌	gvhi
娪	vgkg
褠	puff
䏪	ebg
䥹	qdhb
覣	tvhq
㾑	uwgkw
㥕	oonu
㗛	kttd
淋	iss
䖋	hamw
秌	oty
蓫	aepu
㸴	drhj
岌	meyu
䣑	djfb
舲	tewco
獥	qtrt
吇	kbgc
葃	ajtf
艓	teas
戅	ujan
署	lftj
㰗	sdhh
胴	emg
兹	uxx
䑆	eude
怚	negg
㠶	mhtm
矇	hape
癷	wfjx
日	jjjj
䰈	deua
㝥	pnho
䍳	udcc
蒱	argy
阶	bwj
䊂	ogmi
呿	kfcyy
珊	gmm
敉	otyg
诅	yegx
祔	pywf
㿝	rcu
碏	dajg
㐺	wwwy
懛	nfkf
鎎	qrno
碖	dwga
炆	oyyz
仧	hwu
札	snnt
簆	tpfc
男	ll
翦	uejn
䧢	bakk
穂	tgjnp
秇	tvyy
㹳	qtgk
尜	idi
珃	gmfg
挥	rpl
塭	fjlg
绿	xv
䞠	fhdd
䛸	yyhk
榅	sjlg
㪫	hpgct
藕	adiy
寛	pahq
枀	wcsu
遗	khgp
炒	oi
䵚	twiv
䧒	bsww
䟙	khav
䙸	hqfi
甗	hagn
蒭	aqbtq
摒	rnua
䙦	puaq
㡪	mhet
䒺	axiu
胑	ekwy
譅	yvyh
馗	vuth
姥	vft
咔	khhyw
䣙	meeb
醓	sgpl
訳	ynyy
杙	say
蚇	jnyyh
蓘	auce
土	ffffx
邢	gab
桼	swiu
賠	mukgk
瀁	iude
琽	gftj
濷	iiay
猹	qts
䟽	khyqj
裛	yceuv
鬊	dedjc
簎	traj
筓	tftf
兆	iqv
肸	ewfh
罇	rmuf
鋰	qjfg
祑	pyrw
钮	qnf
䜍	ydui
锐	quk
䩓	afqc
壌	fufe
倶	whgw
痴	utdk
䨕	figf
怃	nfq
㞑	nffn
坋	fwvn
规	fwm
我	q
㟧	mkknb
盽	hdhh
袳	puqq
㾗	uyver
齗	hbrh
澝	ipne
饽	qnfb
㝎	ppu
六	uy
徉	tud
饷	qntk
稛	tlty
彄	xakk
賂	mtkgl
釋	tolf
畯	lcwt
䨐	fwgkg
荰	asffp
膡	eudhn
鼍	kkl
嚊	kthjx
禺	jmhy
埑	rrff
誳	ynbm
绘	xwf
䋆	xynt
咪	koyr
翏	nwer
㱕	hvph
稆	tkk
忻	nrh
虡	haow
蝩	jtgf
㝘	pyf
照	jvko
鄘	yveb
锷	qkkn
脖	efp
㪖	vihc
堛	fgkl
篒	twye
荨	avf
叢	oguc
㫓	jtnn
膰	etol
毢	tfnsc
㽝	gqjlu
鍥	qdhd
㕸	kug
跢	khqq
誯	yjjg
褡	pua
敯	najc
脶	ekm
眈	hpq
䑶	tege
㟤	mviu
斈	ybfs
评	ygu
磒	dkmy
笳	tlkf
㭼	sijg
苌	ata
㐜	fiyv
㥳	ndri
捍	rjf
裑	putt
鋓	qtjhm
囓	kdhb
誮	yawx
昃	jdw
邩	obh
䨤	fmpu
焼	ofaq
㵦	idap
舖	wfkyl
蜷	judb
鉥	qsyy
錭	qmfk
㟇	mwwf
椭	sbd
橽	sfup
焫	oamw
㕋	dqdz
㕒	dugt
㙞	fths
妼	vntt
檛	smnp
涚	iukqt
鏝	qjlc
襮	puji
杖	sdyk
戠	uajdh
掎	rds
㛕	vkcn
漯	ilx
甄	sfgn
㔉	ntkj
呋	kfw
嗍	kub
暭	jrif
謲	ycce
蕶	afwc
迤	tbp
鬗	deay
昔	ajfz
䙏	pugf
褰	pfje
盦	wynl
釀	sgye
勁	gval
菁	agef
㟔	mwyk
璹	gfnf
螅	jthn
䕜	anyf
鐪	qhalo
媚	vnh
㯸	svhl
䏒	ethn
隇	bdgt
䍄	rmhk
㶂	iiaw
劳	apl
蚙	jwynf
愊	ngkl
郅	gcfb
㙢	famy
偷	wwgj
蕩	aijr
氖	rne
㭨	sahb
䜔	ydap
幦	nkuh
娾	vdffr
薷	afdj
㿌	uwgw
瑵	gcyj
臧	dnd
佑	wdk
翾	lgkn
螚	cexj
諥	ytgf
䑑	ahnyr
黗	lfonb
跕	khhk
瀣	ihq
峲	mtjjj
妰	vthf
镅	qnh
鉫	qlkg
曮	jkkt
鎖	qimy
辣	ugk
岕	mwjj
叽	kmn
侚	wqjg
蚄	jynk
㖝	fikx
㠰	lknbq
羼	nudd
䑷	teyen
淯	iyce
曵	jxyi
遘	fjgp
櫤	stuj
僳	wso
纶	xwx
齧	dhvb
夗	qbnb
澉	inb
䗫	jyss
櫖	shan
踎	khgk
敭	jgqt
传	wfny
蠔	jype
谢	ytm
㲮	tfnkb
謘	ynuh
䛼	yvag
瞊	hyvk
髚	ymkm
椅	sds
誟	yftb
䜄	ynih
芍	aqy
榸	sfjfx
職	buaj
䴽	swwf
嫘	vlx
圩	fgf
堧	fdmd
薃	aiyk
龧	龧
銙	qdfn
㬻	eayqg
楕	sdae
篁	trgf
致	gcftm
浮	ieb
獫	qtww
塚	fpey
吅	kkg
偌	wad
䔯	asgd
兌	wkqb
愩	namya
娄	ov
拁	rlkg
䬝	mtjw
脀	bige
磓	dwnp
饳	qnbm
㢦	sksal
腔	epw
缀	xcc
䤪	qmsy
鎵	qpey
瘌	ugkj
㫺	wwwj
㺆	qtym
钡	qmy
郸	ujfb
漳	iuj
硭	day
而	dmjr
蒠	athn
穿	pwat
覌	chqn
莤	asgf
亁	fjfn
袵	puwf
侮	wtx
㷺	qvto
耎	dmjd
怋	nnan
筑	tam
䁴	hylg
詿	yffgu
累	lx
禀	ylki
䧮	bpdn
旸	jnrt
沲	itb
秛	thcy
竊	pwtc
䂮	dhvd
朽	sgnnh
胦	emdy
睗	hjqr
椦	sudl
喋	kans
梘	shqn
攖	rmmv
摵	rdht
浲	itdh
䑢	tegq
澽	ihaen
錨	qalg
㔫	dxb
栚	sudy
窃	pwav
命	wgkbu
粑	ocn
溘	ifcl
㤃	nyn
聉	bbmh
义	yq
鐥	qudk
䰒	deae
䛉	ynan
圚	lkhm
忘	ynnu
㑬	wvdg
坠	bwff
僝	wnbb
獈	qtul
聛	brtf
谳	yfm
榩	shay
罃	oopmu
㺎	qtyhq
店	yhk
幛	mhujx
嗙	kupy
烲	rroup
缃	xshz
枙	sdbn
㪮	fkkcb
覙	qihq
踪	khp
佀	whnn
嫊	vgxi
诼	yey
鞅	afmd
㫜	jjgge
笩	twau
蕌	ajjj
翖	wgkns
败	mtyp
㕝	dcun
徹	tyct
㥭	ndwi
㶯	oqtb
肹	ewgn
尧	atgq
礯	dooi
唷	kyc
砧	dhkg
荭	axa
靬	affh
肢	efc
詯	ythg
㴷	ibpq
杺	sny
藝	afwco
衾	wyne
嵸	mtwhv
玊	gyi
曂	jamw
嘐	knwe
钗	qcy
髠	demb
姙	vwtf
攳	fcvf
翺	thin
惊	nyiy
俘	web
靮	afqy
濐	ijfjc
奚	exd
哝	kpe
裞	puuqj
坤	fjhh
㖖	ukfn
逝	rrp
磄	dyvk
釶	qbn
傒	wexd
臬	ths
䚼	ynfg
㬎	jxxo
獘	umid
䒘	atuw
䩤	afhq
犀	nir
訂	ysh
淥	ixgi
䟢	khqid
䗥	jtwh
嵺	mnweg
励	ddnl
扜	rgfh
㧱	wgkr
全	wg
㹋	trwe
梨	tjs
崲	mrgg
蕡	afam
賔	pnmu
㧝	lkrj
硎	dgaj
淘	iqr
楜	sdegr
肏	tymw
䊋	onhf
瑏	gpwt
酮	sgmk
䶝	hbdw
穓	tlaw
醙	sgvc
䍽	uddh
㤶	ndne
㢠	mkpd
捧	rdw
䛹	yxey
䓰	asffv
㟿	mada
胇	exjh
㴨	ieud
䢗	mapd
謉	yrqc
㟳	mssys
呸	kgi
倩	wgeg
箴	tdgt
仕	wfgx
狩	qtpf
渋	ihiy
䎯	diaw
哜	kyj
䆬	pwkm
猒	jedy
濕	ijxo
浚	icwt
䧧	bugt
萩	atou
浊	ij
㧸	rybh
僄	wsfi
㙏	ftjt
胾	famwf
葋	aeqk
䁦	hhag
侪	wyj
䍝	lijf
犯	qtb
琙	gakgp
巨	and
責	gmu
黧	tqtoo
䈗	twct
罝	legf
袽	puvk
宽	pa
䊞	oumd
讍	ygkk
杼	scb
品	kkk
翜	ndww
烚	owgk
僁	wton
䇥	tghf
脗	eqrk
懜	nalq
讄	ylll
䄝	pydv
䆩	pwhd
㭑	sfiy
㿞	rtfns
㡮	xxdn
傰	wmee
洞	imgk
渭	ile
呾	kjgg
葐	awvl
鈽	qdmhb
竬	utky
咘	kdmh
㹩	qtcf
鑄	qfnf
篍	ttou
伊	wvt
㕔	dbgn
瞋	hfhw
暂	lrj
筱	twh
越	fha
晰	jsr
櫄	stgo
覉	safk
倓	wooy
応	yni
稈	tjfh
滼	issy
蛯	jftx
寶	pgrm
罖	lwyu
兖	ucq
䟘	khym
喽	kov
氐	qay
堽	flgh
鍍	qyac
㹏	trag
徛	tdsk
篊	tiaw
壉	fhae
䘉	gdjjr
靶	afc
嗘	kexd
㴁	igdj
㴾	ifpt
賗	mkkh
褤	pufe
向	tm
娃	vff
蕴	axj
颸	mtjnj
通	cep
䝢	eejc
凨	mfci
䟿	khvi
湸	iypm
梼	sdtf
伻	wguh
剢	eyjh
悲	djdnv
畾	lllfe
㒷	mwgwd
膬	etfn
侦	whm
卦	ffhy
揷	rtfv
䐤	euda
㙮	ftwk
毾	jntn
忇	nln
勚	anmlv
䨨	fwnp
线	xg
媎	vftj
侙	waag
铥	qtfck
蒙	apg
㱲	gqul
才	ft
䣯	sgeg
昋	tdjf
杠	sag
输	lwg
訜	ywvn
筘	trk
彼	thc
雾	ftl
镭	qfl
趈	fhhk
堟	fxey
嚧	khal
闫	uddv
䂠	dtdy
䍂	rmgf
嬗	vylg
佒	wmdy
喙	kxe
㨢	rcex
䏯	efnyt
汧	igah
脕	eqkq
谞	ynhel
嚻	kkdk
鲉	qgmg
䵺	fhnnh
㰼	adwwm
籭	tgmx
䠰	khay
倀	wdey
暊	jdmy
㒉	wips
餼	wpro
転	lfcy
䐮	eutg
䊷	xftt
兯	ubj
魤	qowx
睴	hplh
㙧	fgjl
変	yotu
灪	isre
疋	nhi
漊	ikgv
紑	xgiy
軍	plj
魬	qorc
譓	ygjn
円	mhgd
茍	gjgk
鵖	vcwow
基	ad
䩋	dmjs
無	rlgo
柌	sngk
爨	wfmo
㱩	gqfd
讒	yqky
緘	xdgti
繵	xylg
亹	yvmg
欥	jqwy
澧	ima
䗧	jyvi
鼹	vnuv
生	tg
禵	pyjm
鞾	afaf
签	twgi
摶	rgjf
攃	rawi
匯	aiwy
籮	tlxy
彠	vakc
夊	qyi
颽	mgkjp
軵	lwfy
誥	ytfk
㕁	qdcb
尠	adwt
頗	hcdm
㡘	mhuo
槤	slpy
脎	eqs
艧	teac
鹗	kkfg
楶	uqws
魰	qoyy
曬	jgmx
顬	fdmmz
囟	tlqi
龤	wgkrm
歜	lqjw
䋥	xjfg
囇	kgmx
嶋	mwvoq
鷟	ytto
䥜	qusy
畭	lwty
閵	uwyd
傩	wcwy
㐦	vgnn
希	qdm
䫬	aqam
軰	uxlj
䫞	ugom
儛	wrlh
氢	rnc
嗣	kma
嘅	kvcq
䦩	uhti
鶀	wvgwb
䮳	ctol
馼	cyy
䱼	qonex
歐	akkwu
䳧	wvgdn
厙	dlky
蠵	jmwk
躌	khrhv
䖹	jgjf
襷	puvr
飒	umqy
倲	wgji
鶌	nbmo
䎘	vfjn
萯	aqmu
䫎	cccmj
㘛	kwgd
嚾	kaky
䉭	tvln
穧	tyjg
㵣	ijqw
䡼	lfkk
骿	meua
凄	ugvv
縼	xythr
枈	xxsu
㒥	wdhu
淒	igvv
籔	tkgt
䱔	qowtz
磐	temd
輄	liqn
节	ab
筲	tief
辊	lj
螳	jip
魑	rqccx
譁	yagf
猙	qteh
讜	yipo
歗	vfjw
驈	ccbk
䦇	dwnn
魸	qotnm
驒	ckkf
辉	iqplm
顙	cccmw
囒	kaui
頟	tkdm
驩	caky
殦	gqwo
鵤	qewo
繯	xlgen
宸	pdfe
鶿	uxxof
穅	tyvi
揮	rplh
撋	rugg
缎	xwd
鯧	qojj
搛	ruvo
郒	yvccg
䗟	atdjf
䳥	mwyog
緢	xalg
槧	lrsu
塷	fhlo
褙	puueg
挻	rthp
甠	jtggc
攈	rynt
撳	rqqw
蔿	aeto
区	aq
鋬	rrcq
滉	ijiq
敐	dfet
䔨	axty
爒	qodin
約	xqyy
鱻	qoqoe
嚠	kqyj
鰶	qowi
憔	nwyo
秕	txx
乧	ufnbj
㕼	kqqn
匓	qvcc
隡	butg
㲪	wgkn
䕓	apwi
㝅	fpgcp
曀	jfpu
獜	qtoh
黐	twic
五	gg
絶	xqcn
楯	srfh
鰨	qojn
躿	tmdi
饀	wpevj
頰	dwwms
踂	khbn
猩	qtjg
蔣	anhff
㙟	fyve
骺	mer
譺	yxth
葂	aqkl
顇	ywwm
輗	lvqn
㾙	uqdh
鴜	hxwo
膔	eynx
䈙	txfu
鹤	pwy
癨	ufwy
紻	xmdy
瓓	gugi
繎	xqdo
䪷	qkdm
齃	thlnc
韑	iqnh
鶶	yvho
齏	yjdg
髌	mepw
䗜	jqyl
揱	iejr
妪	vaq
朡	eqbtq
蕙	agj
賓	pgim
堆	fwy
濩	iawc
螘	jmguh
凈	uevh
蝂	jthc
鯹	qojgm
隺	pwyd
㓭	jqwj
噶	kaj
㬮	jaky
慸	aqpn
㠍	mwys
㸥	thgyw
螖	jmeg
䘯	puie
澒	iadmi
礁	dwy
鲊	qgtf
竐	umcy
鏉	qgkw
㳆	iufh
覸	ujhq
㰣	hxqw
㲬	wyon
騇	cwfk
肃	vij
鴱	aqwo
䰗	hggn
龭	龭
㝃	bqkq
澹	iqdy
鋟	qvpc
硛	dyoy
嬀	veto
㔂	oqajr
颕	xfimk
䩍	dmji
䌛	qyti
㚄	fplhb
魽	qoaff
㗬	ipkq
䱡	qoqon
䃁	dghg
搩	rqas
騿	cujh
餣	wpdn
鹕	deq
瑢	gpwk
栃	srdn
鼪	vnugb
閎	udci
囎	kmuj
俆	wwty
紖	xxhh
趡	fhwy
鶵	qbto
嘴	khx
囂	kkdkg
閜	uskdi
䳆	rwvog
鼏	phnn
頨	ndmyy
䯡	meuo
緤	xansm
譕	yrlo
橪	sqdo
㜹	vhhy
鱑	qoawq
爻	qqu
蟛	jfke
鹝	gkmg
䫩	cccm
䝀	gkul
鱔	qouk
籒	trgl
繝	xueg
騠	cjgh
灏	ijym
鲃	qgcn
楈	snhe
繿	xahl
䋾	xdqq
唢	kim
麶	swwc
洗	itf
騃	cctd
䕿	aakoa
兎	tkqy
龓	deud
䳂	vkwom
韡	nhkfb
舊	awyvj
轛	logf
燶	omae
㢳	xtey
䴪	ynjij
鋹	qdey
睓	hmaw
鮽	qowt
該	yynw
浾	ifoy
嗚	kwno
裆	puiv
會	wgljs
茱	ari
鹡	iweg
㩓	vamr
瓯	aqgn
聞	ubd
䬠	fnuh
麌	ynjd
轁	levg
䈫	txmw
蠨	javh
俈	wtfk
斡	fjwfi
鳯	mwvod
啞	kgfg
郔	thpb
䘞	pucg
䚠	qejx
鶇	gjio
鳢	qgmu
仰	wqbh
靥	dddl
綁	xdtb
鷔	gqtov
諆	yadw
鯛	qomkk
䙞	puwu
哣	kgku
㰋	shim
栄	ipsu
騺	fufc
饊	wpat
劖	qkxj
㑇	wqvg
䞮	fhwt
椣	smaw
驔	csjh
㱯	gqmu
濱	ipgm
鰴	qomt
邎	qytp
䀰	hwwk
档	si
椎	swyr
徻	twgjy
鳠	qgac
䌕	xyss
輞	lmun
棊	adws
谻	wwkt
郗	qdmb
顉	qdmy
麗	gmyx
堚	fplhc
曃	jvip
壣	fbxg
䧬	bpgm
穄	twfi
䋴	xdbs
餁	wpwf
鷣	sjwo
驍	cffq
赓	yvwmh
䳳	bmfo
䯀	cbbb
嗀	fpgce
鯘	qotv
瞜	hkgv
瘊	uwn
媲	vtl
鮇	qofio
騦	clny
睎	hqdh
班	gyt
躺	tmdki
傕	wpwy
觹	qewm
䋸	xrfh
骈	cua
鴍	ywvod
㼡	rign
癡	uxth
稣	qgty
聱	gqtbr
祪	pyqb
劶	rgkl
鹖	jqwg
鬭	hggrw
綅	xvpc
赜	ahkme
関	uudi
䮵	cujf
鵯	rtfo
檱	staw
囋	ktfm
繗	xoqh
輴	lrfhz
醫	atdg
䈥	tqel
閨	uffdi
牜	trdj
䲈	qoys
鴃	wvgwm
閶	ujjdc
㩗	rmwe
鯪	qoft
鰪	qoflp
鉎	qtggm
窎	pwqg
豥	eynw
軪	lxln
䶴	oqwa
靏	fpwo
趲	fhtm
鮒	qowf
降	bt
㰻	fkuw
駓	cgig
䮓	chjh
癞	ugkm
疄	loqh
䘙	tnhhz
䡍	lfwye
晟	jdn
睄	hieg
敱	mgkc
㪹	lvuf
蓒	alfjn
醮	sgwo
晨	jd
締	xuph
㰵	ywww
㷤	fpgck
㢤	faqvj
腦	evtq
洚	ita
㿫	xxhc
䧲	fwyg
唋	kwty
䐭	eaqh
䎙	pgin
㲅	pdhc
駖	cwyc
僜	wwgu
儎	wfal
鱱	qody
锻	qwd
捁	rtfk
登	wgkur
䰲	qonn
甞	ipkfc
闌	ugli
鱀	vcao
㩱	relfs
卵	qyt
䴁	pjmo
䮩	cmeg
夝	qtgg
漓	iybc
餃	wpuq
臕	eyno
㹌	trug
鬮	hggg
骭	mefh
駂	xfcy
㪶	djuf
阰	bxxn
䫛	wntm
絰	xgcf
嶃	mlrh
脠	ethp
豎	ahnu
脑	eyb
憏	nwfi
灋	iync
餅	wpua
榤	sqas
䭾	cdy
騻	cdqq
䴜	hlocz
䆣	pwde
毎	txfj
㨛	ruwy
悗	nqkq
麁	qynxw
夐	qmwto
縊	xuwl
鏊	gqtq
籟	tgkm
骷	medg
䲵	itwo
犣	trvnl
稍	tie
嶥	mduw
䯎	mewf
瞺	hwgjo
蘪	ayno
禈	pypl
帺	mhaw
飰	wpyh
嶻	mfay
性	ntg
摊	rcw
䯙	megy
䅻	tybc
瑴	fpgcf
櫦	syntm
紿	xckg
叛	udrc
蝨	nfjj
鋠	qdfe
㙌	fvij
䥣	vamq
䌵	xnij
侲	wdfe
瞉	fpgcw
樐	shlo
伛	waqy
膦	eoq
攟	rynti
鰻	qojc
延	thp
鵔	wvgtd
捎	rie
軞	ltfn
踬	khrm
戡	adwa
䌣	xtpn
飠	wpu
賡	yvwm
媘	vxxr
碘	dma
菮	ayvw
郼	nhkb
雋	wymm
䉕	tulj
䏈	bxxi
躥	khpnz
㿈	uxty
䡬	ljlc
䭿	crwy
墆	faqh
䝁	oopu
唺	kmaw
餆	wpiq
䬣	wyvng
詞	yngkz
絎	xtfhf
啛	kgvv
枊	sqbhf
浸	ivp
龋	hwby
俗	wwwk
隥	bwgu
鱌	qoqe
滯	iaqh
薨	alpx
驻	cy
證	ywgu
庫	ylk
鹑	ybq
餄	wpwk
鼸	vnuo
䨈	pgiy
滻	iutg
眚	tghfl
囌	kaqt
䆍	tuedn
瑪	gcyt
蹔	lrkh
媷	vdffz
讽	ymq
谁	ywygn
矎	hqmt
葷	aplj
嚃	klip
慛	nmwy
䡠	lhmy
袯	puny
榥	sjiq
繢	xkhm
泲	itnt
臞	ehhy
殿	naw
欎	sqqf
㻖	gviyt
䧭	btlnt
臏	epgm
疯	umq
䴂	qjeo
臖	vmge
䟫	ipkh
䚦	qerm
梚	sqkq
颙	jmhmf
癈	uwxc
赼	fhqw
獗	qtdw
鸑	qtyo
蓶	akwy
鮕	qodg
葤	axfu
㩔	rnac
㘍	kiwa
鴉	ahto
㦨	nugi
摗	rgkw
䯹	devc
㞮	mqyu
䊌	oyxx
桜	sivg
遴	oqa
媹	vqyl
䬦	wyvc
負	qmu
蟪	jgjn
㕽	knyw
綸	xwga
髋	mepq
钄	qaui
鷠	qowob
期	adwea
覗	ngkqq
䲢	eudg
眞	xhnw
驉	chag
䡃	lln
轘	llge
㜵	vycej
䯝	mede
鵋	nnwo
鱟	vqqon
嘍	kkgv
泻	ipgg
㿿	nhlf
揗	rrfh
鏛	qiph
擁	ryxy
䮨	cpuh
豌	gkubx
縯	xpgw
馷	cgmh
迅	nfp
嗷	kgqt
頣	ahnmj
㯞	sxke
紬	xmgs
愄	nlge
雑	vswy
鹭	khtg
䮯	cgqt
糩	owgj
珹	gdnt
鏿	qips
䯛	mepb
䌌	xnrg
䬮	wyvwe
嬹	vvmw
䚞	qesw
瀈	inpl
蹬	khwu
膁	euvo
罊	lbmm
颚	kkfmd
㰫	tfqw
雠	wyyd
贊	tfqm
㫷	adwj
絠	xdeg
餰	wpth
摋	rqsc
篶	tgho
亪	yoyu
䟅	lrfh
騰	eudc
葔	awnd
㐀	gjgg
㼈	glxy
鲅	qgdc
欧	aqq
莰	afqw
鯣	qojrg
寑	pwvc
䧻	wgkyf
幯	mhtb
溩	iwno
磚	dgjf
閷	qsuw
斷	xxgr
䣣	ipkbl
錚	qqvh
驿	ccf
㿃	uaqh
憑	ucnu
骹	meuq
鼩	vnuk
䍜	lwyf
䑌	eugi
䃂	djxx
鯇	qopq
鐡	qfau
颍	xid
鼭	vnufv
䀼	hdfe
齋	yjiup
㜶	vqkyw
椉	yqasa
䲛	qoah
嚱	khaa
癹	wmcu
鹉	gahg
簱	tyaw
濯	inw
埡	fgfg
熺	ofkki
愌	nqmd
榫	swyf
営	ipkkm
涞	igo
魠	qota
訩	yqbhc
踭	khqh
羟	udca
䵅	gqtt
鸲	qkqg
䫔	dhvm
䇨	ttah
㜐	vmgu
䫜	xxmm
淟	imaw
䉎	tips
䉆	twvo
㤙	lnnu
䐌	mawe
臙	eauo
鰍	qoto
唤	kqm
䳮	eynov
匶	aawv
魮	qoxx
勘	adwl
䘮	fwwe
髁	mej
谷	wwk
䶰	txtn
樕	sgkw
䉶	twyc
䪳	vtdm
繜	xusf
垙	fiqnj
䱏	qogu
㢈	ywyd
欢	cqw
枾	sfjg
鶬	wyvoy
㢡	nhda
闉	usfd
䉇	tadj
顯	jxxm
鹪	wyog
鵇	rhfo
撜	rwgu
擠	ryjgy
儠	wvln
艛	tekv
䥽	qnty
丁	sgh
鴐	lkwo
䉉	tqey
簸	tadc
鵽	ccco
鴠	jgwo
姺	vtfq
擒	rwyc
䪢	tnhg
礐	vqqd
韲	ydjg
蓖	atl
櫊	sutk
洙	iri
䁡	huwy
撧	rxqc
蝒	jdmds
軱	lrcyy
媁	vnhh
鶼	uvoo
练	xan
臃	eyx
蠗	jnwy
蟚	fkuji
御	trh
鴹	udwo
妈	vc
爓	ouqv
嗎	kcy
䪉	afvn
䱩	qomn
頾	edmx
魴	qoyn
錪	qmaw
痘	ugku
鱳	qoxs
龞	umiga
趟	fhi
鰛	qojl
絅	xmkgc
峹	wtmj
䭴	cfj
㦊	nagf
碩	ddmy
楷	sx
䪕	nhko
䕼	aaky
纰	xxxn
檋	sawl
㜜	vgqt
綡	xyiys
觚	qer
䪓	nhkkl
䫴	ssfm
齿	hwb
廚	yfkf
偝	wuxe
潕	irlo
絺	xqdh
橓	seph
鯼	qoqt
鴖	nawo
䩏	dmjt
緟	xtgfm
鹻	hloo
鵆	twvh
澌	iadr
欓	sipo
違	nhkp
䡯	ltln
闙	uynk
㡇	mhbn
俫	wgoy
瑺	giph
䫊	gikm
㐅	qtyb
䜰	wwkf
㔟	tgvl
爝	oel
䯞	memk
絨	xadt
瑍	gqmd
䤤	qynw
埆	fqeh
嫵	vr
鬫	hggt
䂋	dahs
䬷	wyvqw
績	xgmyh
鉛	qmkg
鹅	trng
鱠	qowj
㥴	nrhm
夨	gnyi
馪	tjpm
蟷	jipl
鮄	qoxjc
鐫	qwym
轤	lhal
鮌	qoyx
䊸	xfnnx
䬪	wyvis
䠮	khuc
韛	nhkeo
觝	qeqy
嚭	fkuky
㩩	rxim
儞	wgwq
枫	smq
怄	naq
煢	oopf
蔯	abgi
禯	pyme
䃶	dyle
垐	uqwf
陥	bqhj
酀	aukbn
㯋	xsdm
头	udi
覼	gwmq
脰	egku
鸒	vgnoi
㽪	lulj
霞	fnhcq
㪺	dhhf
穲	tgmxr
杴	sqwy
㰈	sslp
呞	kngk
轌	lfvg
鶱	pfjo
饢	wpge
癋	ugfn
甚	adwn
䫱	dmjmg
繽	xpgm
鶗	jgho
燓	sqqo
轆	lynxl
歘	ooow
遱	kgkp
鰁	qoriz
饐	wpfu
䃰	dpwi
鷸	cbtor
鶋	ndwo
鸓	lllo
䉃	tnhf
鮛	qohi
氭	rngi
䜹	gkui
飓	mqh
䋑	xgmw
嗹	klpy
鸠	vqyg
敟	mawt
䱶	qoyb
蘰	axjc
䦛	uqvh
骝	cqyl
阪	brcy
顨	dmdj
輖	lmfk
馤	tjjn
玀	qtly
巜	bnn
毇	vomc
乃	etn
鼥	vnuc
䅷	tawt
癲	ufhmo
㜣	vqdo
偩	wqmy
豆	gku
罶	lqyl
秉	tgv
綫	xaat
䮠	cgkl
麎	ynje
潑	iwxc
鸘	fsho
僖	wfkk
繫	lbmi
粄	orcyo
钢	qmq
鹨	nweg
㴍	ibdi
顰	hidf
絁	xtbnf
嶼	mvgw
䌀	xtuf
瓌	gyle
巓	mxhm
綃	xiegt
閺	ujyi
䮐	cmwkq
㰨	kwqw
䳐	uqwor
產	ydtg
鲱	qgdd
㜺	vtfm
墼	gjff
螻	jkgv
嘭	kfke
鷀	uxxob
气	rnb
攉	rfwy
䴣	ynjhm
蘔	axtm
䉾	uxou
㰹	dgkw
鹟	wcng
黮	lfonz
䭩	wyvdt
珱	givg
䩌	dmjoq
硢	dwty
隒	buvo
䲃	qovs
鰼	qonr
㤊	nqqya
瘂	ugfgq
䩣	afwt
颡	cccmc
㷪	owye
韄	afac
魁	rqcf
鷏	fhwo
凫	qynm
淇	iadw
觡	qetkm
萑	awyf
駠	cqtb
绛	xtah
驵	ceg
縨	xjiq
㓖	ujaf
䵥	lfoc
硷	dwgi
顾	db
靌	fpgm
琨	gjx
䩨	afden
㕙	cwty
斗	ufk
㙋	fadw
撝	reto
靍	fwyo
刈	qjhw
㔠	jqwl
净	uqv
㨂	rgji
餩	wpww
妣	vxx
骶	meqy
澮	iwgj
犫	wyyh
悩	niqb
櫂	snwy
蟱	jrlo
勔	dmjl
船	temk
齍	yjlf
䪴	pqdm
鎷	qcyh
䭡	wyvnn
虱	ntj
階	bxxr
䰯	rqchd
瀞	igeh
鸁	ynkyk
蘙	aatn
碓	dwyg
磑	dmgu
䰹	qoat
鳪	hwvo
礤	daw
鬷	gkmt
摮	gqtr
亇	qhj
窾	pwfwa
㡒	mhrh
遏	jqwp
綣	xudbs
䛧	yonn
駹	cdne
繕	xudk
澃	edmi
猴	qtw
璸	gpgm
䱘	tjqo
葭	anhc
館	wppn
粦	oqah
兦	tynv
䱺	qomuc
䯁	cyny
䲑	qout
鷄	exdo
亅	hhll
腪	eplhv
㶐	iywn
䲔	qoggw
䎎	nbnny
酗	sgqb
緛	xdmdt
㰪	ffqw
鴺	gxwo
瑎	gxxr
嬾	vgkm
藺	auwy
軭	lagg
験	cwgw
豔	dhdl
骩	mevn
讏	tnhya
㽅	wgkna
㺵	gqwy
壂	nawf
䒐	alpc
黽	mggv
儦	wyno
鰀	qoec
餏	wpyeu
鳈	qgri
軣	liu
㰽	ajvw
隵	bhaa
跼	khnk
䢆	pmdfl
櫓	sqoj
慩	nlpym
斛	qeu
骪	memy
襭	pufm
艄	teie
稀	tqd
覴	wgkql
鸔	wvgiu
㣭	tqbt
鴿	wgko
㕏	dgkfh
䈔	tnhci
櫹	savh
湙	iyod
䲗	qoth
鲐	qgc
巵	rgcv
朞	adwe
驃	csfi
鳸	ynwo
軆	tmdu
驖	cfag
峗	mqdbv
䄛	pylv
蔦	awvop
䪑	nhkx
寜	pnlh
䴝	hloc
塹	lrff
䱂	qoxl
骫	mevy
廎	yxdm
鐤	qhnn
讙	yaky
窖	pwtki
貭	rfmi
䳁	wvgcn
搙	rdff
㬘	jvfjz
嗶	kjaf
鵉	yowo
紸	xygg
䍯	udqb
穊	tvcq
㼂	wfgy
欗	saui
豏	gkuoy
蹳	khwcv
躛	tnhhs
朮	fqyi
靘	geqc
觍	mawqy
㳄	iqwy
牬	trtt
鑻	qsqr
幮	mhyf
鯃	qogkx
闄	usvd
鮬	qodnb
㸌	ofwy
鸾	yoq
羈	lafc
酇	tfqby
嘸	krlo
㨟	rmgu
緀	xgvv
鰥	qoli
鸨	xfq
顕	jogm
眔	liux
麉	ffyx
铮	qqv
䜼	cbtu
䚚	qetq
鶺	iweo
嚽	kgqm
䶆	vnuyf
㡦	mhpm
䞒	fomk
餇	wpmk
轓	ltol
矆	hawc
頷	wynmd
捑	rjgy
綿	xrmh
粛	vojk
䞕	fofjg
濟	iyjgm
㦬	nlxy
鑼	qlxy
愰	njiq
鳣	qgyg
潉	imjx
磤	drvc
脹	edey
鍐	qqbt
䞰	fhfo
鳅	qgto
觌	fnuq
䫄	ukqm
䰘	hgge
䍦	lyby
鏜	qipfb
鼰	vnum
檅	shdt
聕	btfk
䋳	xuxe
鹄	tfkgl
観	rwyq
櫞	sxxe
䡿	lfkw
陗	bieg
凖	uwyf
䧯	bqky
壟	uegf
顧	ynwm
瞖	atdh
錕	qjxx
緕	xyjf
槈	sdffx
㤸	nfoy
䶤	hbme
䶇	vnue
濊	ihdt
凲	muvop
癕	uyxy
﨎	ywyc
鰙	qoak
僲	wsqh
獶	qtdto
凴	ucmb
瞷	hujg
榖	fptc
蜃	dfej
瓻	qdmn
拟	rnyk
帰	ytvh
惟	nwy
鞻	afkv
潊	iwtc
䫑	dskm
䮝	cplh
澙	ivgo
㟅	mqbq
髏	mekv
䊑	oimk
鯟	qogi
䦤	uccc
㔔	lkkf
倄	wqde
帿	mhwd
熝	oynx
鰳	qoal
骻	medn
疪	uxxv
䜪	wwkv
罐	rmay
纃	xyjg
譆	yfkk
雤	vqqyx
䣘	ipkb
嶰	mqeh
綹	xthk
䱒	qokc
觩	qefy
尝	ipf
卝	gjgd
骴	mehx
䮹	chdt
䒋	mdqc
䜺	gkuj
驞	cpgm
㵆	ijtk
鏳	qulj
葯	axqy
償	wipm
䳨	rgwo
㗋	kqdd
琐	gim
闍	uftjn
椲	snhh
板	src
䌙	xamw
緰	xwgj
龍	uegdz
鳌	gqtg
艅	tewt
莚	athp
莀	adfec
䋟	xnnyq
䲝	qgwb
鎔	qpwkm
诚	ydn
鱥	qoht
㙴	fqdy
顠	sfim
䃙	dynx
㢟	hpd
隶	vii
焕	oqm
䂉	cbtde
皬	rfwyb
騫	pfjco
其	adw
翪	nqbtj
䶩	hbyj
㘜	wyyk
䡕	lbig
䝘	eemc
鱞	qole
篂	tjtg
鶘	dewon
䰤	gjic
飷	wpeg
殼	fpgcl
䑒	gcfy
跣	khtq
槏	suvo
軳	lqnn
弪	xcag
䮉	ctey
䓭	aqsj
隿	awyg
赚	muv
鮃	qoghl
魈	rqce
緈	xfuf
狿	qttpf
鯍	qoyq
鋋	qthp
墕	fgho
纕	xykes
䃲	dtel
皼	fpgcc
您	wqin
豄	wwkmb
鹥	atdgi
余	wtu
峸	mdnt
儋	wqd
繱	xaqn
䮾	cued
賌	yntm
欄	sugil
㥍	nadw
鶟	pwdo
觰	qmfj
縭	xybc
确	dqe
䗺	thpj
頤	ahkm
䕞	auye
韗	nhklf
㽌	fqyn
鮱	qofx
禬	pywjm
餠	wptfy
鲠	qggq
睲	hjtg
䨅	dujy
叚	nhfc
鱯	qoac
鏕	qynxz
䴘	rhag
觬	qevq
鹢	uwlg
鹲	apfg
䨁	cbty
䑝	kkph
㘐	kcuq
鱡	qomde
驠	cauo
䭼	cfjh
瞂	rfhc
獦	qtana
焅	otfk
鞝	afik
裣	puwi
瑆	gjtg
鲜	qgu
矱	tdac
禮	pymu
婎	vwygq
比	xx
鴽	vkwo
诌	yqvgm
䚗	qewcx
㶉	iexg
緪	xngg
閭	ukkdz
蕣	aeph
䲀	fufoj
飀	mtjlx
颣	oxim
鶫	glio
㹕	fqdh
㻪	gwye
臛	efwy
綴	xccc
熬	gqtoh
唭	kadw
䳶	wvgd
鵺	ywto
诞	ythp
俛	wqkq
䃀	dgvv
緍	xqaj
擃	rmae
樵	swyo
朆	uljr
繖	xaet
髈	meuy
鄬	etnbc
璯	gwgj
菛	auf
䚡	qeln
維	xwyg
䠬	khwb
鼯	vnuka
泤	inyw
茩	argk
蹗	khyx
搅	ripqm
鴡	egwo
陒	bqdb
㗽	xtykj
閆	udda
們	wug
鱶	qoue
䬲	wyvki
蠍	jjqw
䳲	rdfol
䢯	ooqp
鴛	qbwo
䦟	uwwft
逥	mjdpb
漘	idfea
緗	xshg
㓸	nngj
娛	vknd
虉	agko
鵻	wvgy
鱾	qgnn
麪	swwnx
㰠	ymqw
鱴	qoatl
門	uhng
齂	thli
㸚	qqqq
镲	qpwiu
䯤	mewj
瀺	iqky
䭠	wyvoj
餹	wpyk
輕	lgva
蜼	jwyg
綶	xjsy
嬄	vfpu
鸂	iexo
搗	rwvm
殓	gqw
鳗	qgjc
锧	qrfm
䊵	xvns
䭒	wyvnh
䌜	xogw
䳚	jfwo
欹	dskw
燈	owgu
馮	ucy
鹛	nhq
癑	umae
媐	ahkv
鶙	upmo
緔	ximk
緥	xwks
㔯	amkd
韋	nhkh
騵	cdri
鑣	qynof
塆	fyox
䔠	asie
竹	ttg
飾	wpthd
䌰	xbbb
鬪	hggf
卼	gqqb
僀	waqh
䙫	puuw
毋	xde
餂	wptdc
練	xgli
䚭	qeay
亥	yntwp
馵	caj
爛	ougi
總	xtln
帪	mhde
驲	cjgu
䣊	imkb
鷊	gkmo
檂	smae
腥	ejt
㪤	jaft
仭	wvyy
輎	lieg
㦢	ntvb
豐	dhdu
縌	xubp
䛻	yrfh
瞵	hoq
恑	nqdb
袾	puri
遐	nhf
橊	sgal
䒃	tetp
鴀	giwo
㔃	xqcv
霳	fbtg
䰶	qoync
麙	ynjta
爼	qqeg
確	dpwy
煥	oqmd
藒	atjn
牍	thgd
諝	ynhe
祳	pyde
闋	uwgdc
煕	ahho
㨤	rawy
騚	cuej
轞	lahl
輀	ldmj
䶐	thlj
飗	mqqlu
騑	cdjd
龖	uegdt
祺	pya
埀	tfuf
貑	eenc
㻽	gwym
饓	wpis
斜	wtufr
䟌	fhfy
嶕	mwyow
鰓	qoln
㭄	snfh
隖	bwno
谿	exdk
摀	rwno
惺	njt
椵	snhc
葛	ajq
暶	jyth
璍	gagf
蝎	jjq
驐	cybt
狌	qttg
倛	wadw
餚	wpqe
絼	xeet
崑	mjxx
蘚	aqod
䄼	tglwa
断	on
鱼	qgf
维	xwy
珰	givgl
溉	ivc
鲇	qghk
鶽	wyfo
䃫	dqdy
蜍	jwt
㴋	ivij
䭹	cqbh
赏	ipkm
酘	sgmc
䢲	hhwp
蟐	jiph
輭	ldmd
傺	wwfi
痟	uied
雈	gjgyz
馱	cdyb
䦳	uxtb
駯	criys
䛠	ygku
燜	ouny
縮	xpwj
顿	gbnm
蜄	jdfe
闏	umtj
皷	fkucm
鵲	ajwo
耥	diik
鼦	vnuku
䡄	lmn
偽	wyto
䦶	uqvhj
似	wny
縗	xykew
臘	evlnt
篽	ttrb
㱡	gqtqo
綨	xadw
䁜	hjiq
褸	pukv
来	go
鵰	mfko
䌏	xpnm
䨀	tyoy
紼	xxjh
㿠	riqnb
鯚	qotbf
緺	xmnk
䕌	atwy
駈	crggu
鷺	khto
弈	yoa
䰴	qotn
䢏	ufpk
虇	axay
悕	nqdh
鱕	qotl
鼐	ehn
顀	wydm
橹	sqg
饈	wpuf
刻	ynt
䴧	ynjv
嫾	voqh
騁	cmgn
蟏	javj
縏	temi
巀	miwa
栀	srgb
顴	akkm
瓚	gtfm
鏈	qlpy
㠂	mgqt
争	qv
卂	nfk
瞪	hwg
嬃	edmvx
飚	mqo
䪔	nhky
㺿	gahh
䝏	elvg
䍡	lynx
隸	sfii
㼃	gvln
䂎	cbtmg
瀖	ifwy
鯓	qottj
暇	jnh
䌲	xato
㸄	oyjg
䜸	gkunf
姤	vrgk
嚘	kdet
匭	alvv
䝄	gkucg
氍	hhwn
蓽	ajaf
邏	lxwp
蓟	aqgj
䫙	fasm
赪	fohmf
螯	gqtj
欣	rqw
襏	puwc
㘢	liqv
榿	smgu
咳	kynw
䬚	mtjct
鵵	qkqo
㳽	ixti
敩	ipbt
乗	tgas
飘	sfiq
陎	briyn
騒	ccjy
屢	nkgv
茶	aws
毆	akkc
檳	spgm
面	dm
餪	wpdd
鵅	tkwo
爽	dqq
䳄	hxwod
诮	yie
湋	inhh
豛	emcy
豅	wwkd
捡	rwgi
䌭	xawo
挙	iwrj
䠭	khgm
艜	teah
䋮	xqg
掁	rdey
葮	awdc
骜	gqtcr
鴭	wnno
恣	uqwnh
槳	nhds
䦲	uqdy
䲎	qontc
驫	cccuc
鶔	cbtoq
畱	gajl
餲	wpjn
塡	fxhw
纗	xmwkc
䲒	qoqhq
鴁	tdwo
鴬	ipwo
虈	akkkt
鯬	tqtom
歟	vgnwi
牲	trtg
㗶	kwxc
繏	xnnw
襲	uege
嶦	mqdyx
轙	lugt
釃	sggx
郤	wwkb
廲	ygmx
欴	yvcw
䲺	afwo
齳	hbpl
禶	pytm
豋	wgku
笃	tcf
鸱	qayg
檕	lbms
螫	fotj
鴎	aqwom
㙦	wtuf
鳍	qgfj
駬	cbg
烯	oqd
䃢	dqqw
濳	itfj
蜫	jjxx
称	tq
飏	mqnr
䲕	qouj
歕	famw
熷	oulj
韝	nhkfy
㠜	mxth
緶	xwgqk
鵛	gvao
麣	ynjtb
遛	qyvp
漮	iyvi
鲭	qgge
䭗	wyvq
鶚	kkfo
凝	uxt
䜴	gkucj
䡣	lplh
鷃	jpvo
耀	iqny
斚	ccpf
鳖	umig
頕	hkdm
铢	qri
䴡	godx
毅	uem
繚	xdui
䀽	hthp
燘	ouyy
龎	dueds
㣒	ulje
螜	fpgj
䪐	nhktt
䜫	wwkag
渨	ilge
絑	xriys
䤮	qhit
螭	jybc
龇	hwbx
薊	aqoj
㫿	jwyge
㪻	xyxf
銧	qiqn
脽	ewyg
榕	spwk
䔡	aqou
絒	xyth
縹	xsfi
㜢	vlvg
鐝	qduw
䡝	lpqb
緵	xqbt
遰	aqpp
嬅	vagf
揹	ruxe
㺔	qteo
鳵	nfwo
㝛	pwgw
腯	erfh
预	cbd
䄢	pyyj
緆	xjqr
㪛	adwc
掀	rrq
鰧	eudo
舚	tdqyv
胫	eca
㰝	nqwy
蝌	jtu
騭	bhicy
謸	ygqt
駾	cukq
離	ybmy
姽	vqdb
窤	pwjx
為	ytno
㥃	nugw
鰫	qopk
駙	cwfy
鮋	qomg
闦	umau
噸	kgbm
坣	ipff
锨	qrq
茑	aqyg
繉	xhiq
飢	wpmn
鼔	fkucc
蒍	ayto
穞	tqgj
驌	cvfj
㲝	tfnyf
憆	nipf
稘	tadw
泩	itgg
紒	xwjh
棲	sgvv
糷	oaui
䪲	gqdm
喗	kplh
獭	qtgmt
輣	leeg
喼	kqvn
骂	kkc
陣	blh
碾	dna
蠮	jatn
輳	ldwd
憙	fkund
蘢	aued
彭	fkuec
䌨	xawi
䢾	tfqbc
繧	xffc
㺬	gmyy
鵫	hjwo
﨣	fhuf
换	rq
晐	jynw
㰶	thkw
僢	weph
黉	ipa
臈	eajn
輶	lusg
攀	sqq
㯀	sythf
铯	qqcn
輏	lsgg
駇	cty
鸌	wvgc
撪	rcdl
䯆	menn
塖	ftux
鮢	qori
煨	olgu
赯	foyk
䲼	tgwo
䕡	aukk
櫳	sued
縷	xkgv
鳭	vwvo
紦	xcn
鼑	hhnn
華	agaf
囀	klgf
鵀	wtfol
橅	srlo
䜷	gkuce
顛	fhwmj
䱞	qodi
輍	lwwk
腾	eud
㲃	hjxc
推	rwyg
繑	xtdk
鎭	qxhw
贍	mqdy
闎	urii
㡃	mhwq
䪆	afmu
涤	its
礟	dcqq
玛	gcg
羨	ugiw
㥏	nmaw
㻧	gqas
韐	nhkk
骞	pfjc
慠	ngqt
䫌	rtfmc
裳	ipke
傳	wgjf
䀋	fthl
蜑	thpjt
磜	dwfi
潲	iti
鸣	kqy
鳕	qgfv
躋	khyf
懥	nfph
嵻	myvi
褣	pupk
㢕	yxtyq
篌	twn
憫	nuyy
䚜	qerf
騶	cqbtl
坞	fqng
軙	lhcy
懝	nxth
輷	lqyg
鳘	txgg
麝	ynjf
鬑	deuo
䬻	wyvtb
駕	lkcu
鮣	qoqb
苼	atgfi
臡	akfwv
閑	usie
蕬	axxi
䁷	wfqh
餢	wpuks
䨔	fiqbx
騧	cmnk
䳃	wvgbq
絯	xynw
㦕	nbtg
瘫	ucwy
摟	rkgv
靃	fwyy
鴰	tdwoh
媭	edmv
紗	xitt
䭽	crhh
䴩	ynjio
鲢	qglp
闓	umgu
懙	nvgw
项	adm
漉	iynx
㩳	rwycd
䍷	udnhc
㖦	kgji
䮁	ccah
驾	lkc
麞	ynjjr
韚	nhkfi
榔	syv
禡	pycy
頩	uadm
戞	depa
艵	uaqc
懀	nwgj
㦉	nfpu
䭍	wyvl
紣	xvfhp
鵂	wswo
襸	putm
綍	xfpb
櫭	svcg
㾌	utfq
㷰	oybc
䕥	awwqv
蹶	khdw
㹊	trpy
䬾	wyvt
䦘	uvei
嫥	vgjf
脔	yomw
䲰	fcwo
魳	qogh
馭	ccyl
彮	pwwe
豉	gkuc
岖	maq
䫁	thdm
鼛	fkukw
漸	ilrh
鸊	nkuo
鹼	hlowr
侵	wvp
鷧	fpgo
䲏	qoolq
䐳	eqoy
候	whn
驂	ccce
謙	yuvol
飦	wpfh
踃	khie
䰸	qowci
㷳	dwwov
蚍	jxxn
曣	jauo
駎	cmgp
猾	qtm
頂	sdmy
䌆	xrqc
㰱	tgjw
卸	rhb
葪	aqej
鮳	qofn
仮	wrcy
孲	bgfg
龃	hwbg
羅	lxwy
粸	oadw
纎	xfagr
䩔	afmc
欳	hmawh
駥	cadt
䚝	qeyf
擮	rfay
谸	tdwk
䳼	wvgkn
飐	mqhk
喝	kjq
㽎	adwqj
䲷	wvgs
䡏	lxcy
䲾	agno
灌	iak
㬙	jeton
㽇	wfqnq
光	iq
鷶	lmwo
骓	cwygv
䧊	btfkl
縟	xdff
綢	xmfk
㽓	tgtg
剷	uttj
䭅	wyvdc
挛	yor
瘚	uubw
槝	swvm
䋛	xoy
閌	uymvu
唞	kruf
魢	qonnz
軈	tmdnr
䯄	ckmw
坎	fqw
鯻	qogjm
䎭	ditp
煒	onhh
僂	wlvg
鼵	vnudc
橙	swgu
薌	axtb
觪	qeuh
㢄	ygkuv
羂	lxke
䅆	tuqw
䱾	qolv
䳤	umiod
鰊	qogib
餓	wptt
鷮	tdko
婰	vmaw
昆	jx
䈦	tqbtx
㰩	jqwyj
鹃	keq
豁	pdhk
䯕	metp
鑽	qtfmo
紈	xvyyy
驝	cfps
劊	wglj
䈸	tqef
鷽	vqqo
阄	uqj
瘓	uqmd
㖍	ufkx
糳	oguol
毀	vfmc
嚌	kyjg
焇	oieg
㟕	mkuf
䝙	eeaq
穳	ttfm
浩	itfk
饡	wptm
攑	rvgh
卣	hln
毁	va
㻊	gqkq
䋉	xpwy
㙣	fxde
鈑	qrcy
䯘	mepqv
轚	lbml
䩵	afpln
轃	ldwt
䱰	qotfw
羡	ugu
䐹	evfj
纒	xyjfr
埓	fefy
缬	xfkm
鶤	plwo
䮒	cgey
㕍	dwyd
鵥	udjo
㱁	bmfw
櫥	syffn
䳷	twwof
繬	xfwk
䫨	gqtm
廄	yvcc
鹱	qync
鳰	tywo
弯	yox
樧	sqscu
魾	qogg
䂫	dtah
赞	tfqmz
蘺	ayby
䭋	wyvsa
鷎	rdfo
鱚	qofke
㒙	wxrh
櫚	sukk
晄	jiqnq
細	xlg
擖	rajn
袶	puthz
觕	trqe
澦	icbm
鱊	qock
磇	dtlx
畬	wtlf
䜩	yauor
㟓	mqdh
㳤	iyay
䮆	cgif
䳀	wvgwt
䙈	puwd
鸞	xyxo
䳍	awwou
瞬	hep
㶍	iqod
惲	nplh
軤	ltuh
㒣	wywn
㸡	thgi
颞	bccm
綧	xybg
餻	wpuo
懘	iaqnl
樊	sqqd
篼	tqrq
暨	vcag
繨	xfup
筿	ttsu
桝	sqah
㰮	dfew
嫦	viph
㲀	dfec
步	hi
卐	ghgn
蘋	ahim
鶖	towo
餭	wprg
沨	imqy
垢	fr
鯅	qotpg
蟹	qevj
䅥	tjqnl
鹧	yaog
秼	triy
逺	fnep
㿄	uatc
䡇	lfqn
䇶	tqej
鼄	rimv
䳸	ysso
鐗	queg
卬	qbhi
體	memu
刭	cajhm
陙	bdfe
㹷	qdmd
䤲	qfoy
蠟	jvln
潙	ieto
㑯	wdmyg
穮	tyno
駋	cvkg
䴌	wvgeo
霋	fgvv
醲	sgme
晞	jqdhy
閂	ugd
簛	tadr
鬜	deue
鲳	qgjj
顫	ylkm
㲇	fnmu
䇒	vcau
穥	tvgws
醒	sgj
䪒	nhkg
灉	ivky
甥	tgll
㺼	gnhy
魻	qolh
甧	tgte
擧	vgnr
㪴	fquf
䯸	deuw
䬱	wyvg
䌧	xfnf
紘	xdcyg
閈	ufks
鰺	qoce
鷻	wvgtn
續	xflm
鐚	qgfny
䭝	wvyj
膐	ytew
欈	smwk
㮁	sqde
燿	onwyi
樢	swvo
頦	yntmu
髗	mehl
䰻	qotyw
鼶	vnumu
綵	xesy
軕	lmh
獾	qtay
鰣	qojfj
厾	nfci
锓	qvp
秶	uqwt
绡	xie
䬴	wyvse
䴒	fkko
橮	sqym
襉	puue
䲉	qoar
颹	mtjhb
萷	aiej
蒣	atwt
饗	xtye
剑	wgi
蹕	khjf
馏	qnql
絗	xlkg
䋨	xukg
歅	sfqw
鬠	dewj
孓	byi
鴲	xjwo
拵	rdhb
塽	fdqq
矰	tduj
窱	pwws
急	qvnh
熽	ovfj
橜	dubs
㹰	qtiq
賖	mwty
懮	ndet
䌐	xehq
成	dn
縘	xexd
镋	qipq
楬	sjqn
㱼	nmcy
䲦	wvgdx
㚅	tgtgi
躗	tnhha
漱	igkw
娈	yov
㱬	gqle
鵳	yneo
幁	mhdm
豨	eqdhb
輰	ljgr
閚	uudh
䆵	pwuj
曏	jxtb
鶮	ymko
藄	aadi
預	cbdm
鯢	qovq
䮶	cwys
嬚	vyuo
鹣	uvog
版	thgc
闔	ufcl
㼸	pwwn
魟	qoags
灩	idhl
騋	csww
䆪	iqpa
奞	dwyfz
㛲	vdmyp
搬	rte
歞	jxxw
䳈	wvgnx
厫	dgqtl
裖	pudee
䱊	qooyr
埬	fgji
䋶	xdmy
㝍	pgng
鐦	quga
㖘	kdfe
寷	pdhu
䱪	qogey
堦	fxxr
䨏	fuqw
鶠	ajvo
緧	xusg
䨄	wynyr
凳	wgkm
鲕	qgdjn
頧	wnnmd
㠀	wvgm
㛀	vqvg
騄	cx
辘	lyn
巸	ahkny
蛸	jie
褳	pulp
鏤	qkgv
貜	eehc
経	xcfg
䅱	tmgu
骸	mey
龦	龦
劌	hdgj
饒	wpfq
焿	oyvw
麢	ynjkf
磏	duvo
㰺	nhfw
騆	cmfk
胜	etg
㐁	glwi
䲽	dwvoi
豑	magt
椟	sfn
㒑	waiyu
盤	teml
鷭	tolo
贗	dwwmf
鎨	qwyf
嬝	vwve
晧	jtfk
灙	iipo
逮	vip
䮇	cvfh
縎	xmeg
㸦	ahyi
䜚	ylip
繩	xxgq
瓊	gqmt
㾺	uci
䆶	pwwoi
风	mq
驭	ccyv
鷥	xxio
盛	dnnl
卫	bg
嫺	vueg
彌	xgwq
輑	lvtk
䌊	xerm
奯	dhdtg
軶	lynnh
兜	qrnq
䭕	lrwe
驆	cjaf
奕	yod
㻾	yxty
㰭	dfnw
灕	iyby
䡓	tlfh
芘	axx
鱬	qofjt
膞	egjf
䯢	ysse
䩈	dmju
簉	ttfp
鱣	qoyg
蓴	agjf
鬧	hggh
趱	fht
㫱	jfouf
磝	dgqte
籕	tsql
颟	agmm
象	qje
额	ptkm
鲝	udqgd
旋	ytn
鳶	awvo
麀	ynjxr
䂷	dtfx
鱿	qgd
鳞	qgo
䓦	amaw
㟼	mgqtb
鴨	lwvo
雄	dcw
䵾	wffc
䐴	vcae
鲏	qghc
龫	龫
㝭	pnjg
鰑	qojr
辳	ssde
欮	ubtw
軜	lmwy
嶄	mlrj
頶	tfkm
廱	yvky
餫	wppl
皚	rmguf
勆	yvcl
閴	umit
節	tvcb
鋿	qimk
㪳	ufkf
㪠	uvoc
䌠	dgki
蒹	auv
蠿	vxxj
䬹	wyvft
鶥	nhwo
縀	xnhc
皝	rgiq
丠	uxgf
膶	eugg
鸉	sjgo
勓	xxrl
鴵	iqwo
悎	ntfk
圍	lnhhx
迳	cap
鰦	qoux
鳟	qguf
絳	xtaha
醼	sgao
纁	xtgo
㠈	mugg
䭘	wyvi
䡳	ladr
剘	adwju
麄	wvyx
鵼	pwao
癙	uvnn
莃	aqdh
㑡	wvcb
裊	wvge
鄁	uxeb
䶃	vnun
䬜	mtjcz
蜌	jxxf
䡥	lpwk
礃	dipr
麠	ynjgd
爠	ohhy
瞿	hhwy
浄	iqvh
䧹	ywwyw
赧	fobc
鲪	qgvk
蹷	dubh
蝬	jqbt
闇	uujd
殺	qsmc
駁	cqqyf
缑	xwn
箲	titq
頫	iqdm
洊	idhb
雕	mfky
短	tdga
骢	ctl
七	ag
䄤	pygm
帳	mhder
䕴	atwo
䭟	wyvst
軝	lqan
穒	twvow
膽	eqdy
氺	ihyy
㨨	rqyl
瀊	itel
濪	igec
蘌	atri
鮪	qode
疐	fplh
繹	xlffy
䚵	yufhn
䊢	nhdo
嚼	kel
㽐	afuo
鯕	qoawk
鹬	cbtgn
䖰	frey
鴫	lwvow
鹇	usq
饔	yxter
䱻	qome
穕	twys
鱓	qokf
浠	iqdh
颖	xtd
鹂	gmyg
㱀	qbtw
梫	svpc
䮄	cyxy
䲲	wcwo
紩	xrwy
瑠	gqyl
溜	iqyl
紪	xhxn
廔	ykgv
綊	xdww
洂	iyoy
䲖	qoffm
鯙	qoybn
蠖	jawc
鱎	qotkc
髓	med
雖	kjwy
鄾	depb
瑼	ggjf
硟	dthp
㱽	pqmc
崄	mwgi
縪	xjaf
恠	ndhf
驏	cnbb
䭺	cymn
鮖	qodgp
㤥	nynw
䜻	gkuh
鲼	qgfm
鮰	qolk
幃	mhnh
鮍	qohcx
䱠	qoaa
䴢	ynjs
癄	uwyo
睢	hwygx
䃤	dvfj
鱁	qoep
捙	rlh
㼩	dnnn
䳜	wtwo
廨	yqe
㚑	vdu
䴐	pgro
菟	aqky
㜠	vmwyd
锁	qim
䥗	qffw
匸	agn
喜	fku
曄	jagf
鬇	deqh
戱	hana
紕	xxxnt
櫴	sgkm
曐	jjjg
縦	xtuh
乄	nyie
皹	hcpl
蝁	gfgj
綌	xwwkv
硊	dqdb
鷳	uewo
雏	qvw
䡮	ltwh
閔	uyig
嗛	kuvo
穌	qotyr
鯞	qovha
湏	idmy
汹	iqbh
剩	tuxj
䫇	emfm
䞑	foag
跸	khxf
䖊	qhamw
暷	jgjfu
䲞	qgugm
㦣	tnhn
數	kgkt
輔	lgeyh
緬	xdmd
瀧	iued
琁	gtnh
骆	ctk
啷	kyv
䤗	ujtg
毊	fnmk
澑	igal
暩	jwfi
䮂	cdcy
䕳	axgq
嶝	mwgu
觥	qei
醱	sgwc
䈶	tpwk
堠	fwnd
魛	qovnk
䯊	mesk
鵝	trno
䉏	tqeh
丮	nfhk
䳪	mdmo
斝	kkpf
縩	xwfi
投	rmc
紳	xjhh
緫	xqrn
壍	ilrf
惞	nrqw
䫰	dmoh
鄔	wngb
嗕	kdff
兔	qkqy
㜊	vnae
阂	uyn
艶	magc
䠨	khqyh
角	qe
朩	sghy
縕	xlwl
蕳	aujfy
蒈	axxr
閯	uiit
䫤	pjum
鳝	qguk
熡	okgv
鸄	ryto
紽	xpxn
䶅	vnukz
䴄	epqo
闆	ukkk
䭤	wvyp
䬨	wyvvm
豭	enhct
穦	tpgm
实	pu
骾	megq
䇆	uufh
髑	mel
鹌	djng
䲥	vwvog
祠	pynk
鯯	qorj
銌	qdhbf
敘	wtty
䖷	jqdh
嬔	vqkgs
鴳	pvwo
鸤	nqyg
䋂	xqqy
繆	xnwe
溽	idff
䆅	tuqm
犥	tryo
腆	ema
㞃	wwkn
茕	apn
蔍	aynx
墷	fagfi
㬶	etfk
鹒	yvwg
豇	gkua
渔	iqgg
䵻	hndv
憐	noqh
熓	owno
趭	fhwoi
凂	uqkq
莶	awgi
霍	fwyf
盜	iqwl
陉	bca
䌖	xwys
谐	yxxr
魡	qoqy
邐	gmyp
駗	cwet
謷	gqty
糆	odmdw
㯕	sadr
卌	glk
矔	haky
闞	unbt
軿	luah
鐢	sqqq
嬁	vwgu
㗱	kwys
䶯	vtxg
鵿	wvgav
紆	xgfh
䲪	dwvo
頄	vdmy
憕	nwgu
䯚	mexe
梔	srgc
鰤	qowh
颤	ylkmk
艴	xjq
鰯	qoxu
慱	ngjf
䁰	hadm
眅	hrcy
䭙	wyvjq
磛	lrdf
韙	jghh
䲋	qofjw
蔺	auw
禦	trhi
椩	syvw
縬	xdht
順	kdmy
䲤	qgigb
㨦	rwycu
㽒	lltg
胮	etah
䟝	khmc
韤	nhkt
蕄	aunu
鷅	sswo
訊	ynfh
麆	ynjg
駿	ccwt
譮	ywgj
䡶	lnku
蟂	jwvs
濑	igkm
䁬	hulj
䡹	lfph
軘	lgbn
傲	wgqt
輾	lnae
頢	tddm
撎	rfpu
䲿	nxwo
雔	wywy
輒	lbnn
嵟	mdwy
鼂	jgmv
䟆	fhlf
鹓	pqbg
㬫	aukj
䯒	meth
㚯	vmqy
艬	teqy
㰕	sugt
忺	nqwyr
紁	xcyy
䡦	lccs
鷫	vfjo
㦲	faqv
拣	ranw
嚁	knwyu
驪	cgmx
閁	ute
鐂	qgalw
扳	rrc
垕	rgkf
礀	dueg
䄡	pyqy
檞	sqeh
櫸	svgh
劲	cal
觳	fpgcv
䡙	lyvek
腶	ewdc
枓	sufht
鷛	yveo
褌	puplu
䏶	exxf
鬦	hggfx
堍	fqk
鴂	nwwo
鯽	qovb
㞇	dnle
䭇	wyvkj
饙	wpfm
猃	qtwi
嵱	mpwk
谠	yip
䙻	tnhq
䰾	qocn
獺	qtgm
唏	kqd
臒	eawc
䡘	lqlg
㗨	atdkc
㷠	ooqhi
縙	xabg
錤	qadw
鳳	mdho
刁	ngd
誫	ydfe
閃	uwi
䴫	ynjc
䗡	jghov
驅	cakk
垼	tmcf
㰿	exdw
䊼	xhg
集	wys
騞	cdhd
段	wdm
驹	cqk
堫	fqbt
赠	mu
臌	efkc
纋	xdet
埗	fhitj
愼	nxhw
鏻	qoqhl
㯂	saqh
㩴	rhhy
嬵	vxrh
䙉	purh
峭	mi
絀	xbmh
駵	cgan
繙	xtol
䋩	xvqn
蹰	khdft
经	x
嬳	vawc
輲	lmdjc
鴑	vcwo
䬳	wyvfd
猠	qtmw
䱨	qogjo
綗	xmwk
螰	jynx
萪	atuf
䨠	fjqnh
組	xegg
頀	ujac
颥	fdmm
闕	uubww
爾	gwmqo
㠎	mwysg
俏	wie
骥	cux
摕	raqh
司	ngk
閞	ucak
葨	alge
驢	chal
臩	nhaj
換	rqmd
齈	thle
䱬	qone
䚪	qele
蠏	jqeh
轍	lyct
簫	tvfj
龌	hwbf
䳴	liwo
鎌	quvo
饠	wply
蓷	arwy
鴇	xfwo
纘	xtfmw
銖	qriy
蔅	auvfg
濂	iyuw
䳘	wvgt
絞	xuqy
䮚	cfwt
㚊	qqyw
紺	xafg
澎	ifkez
澗	iujgb
糠	oyvi
騴	cjpv
鷱	thio
䩃	dmjx
輓	lqkq
鉨	qqiy
龐	yued
䯖	mtye
饮	qnq
䠪	khxnw
䨥	fwyc
歀	sfiw
䗯	jwyp
藑	aqmt
閇	ughi
䛐	ngky
炼	oanw
資	uqwms
㔞	tful
隈	blge
䔳	aqdo
馬	cggy
蚂	jcg
廉	yuvo
㸊	ogkm
㰾	ryqw
糹	xnnym
镏	qqyl
䧼	tfky
猉	qtawu
掗	rgfg
㳧	ibnn
觽	qemm
鹚	uxxg
顥	jyim
抑	rqb
䲱	wvgyu
哌	kre
髆	megf
隐	bq
䧦	beto
麊	oynxc
豼	eexx
寳	pgqm
廘	yynx
黵	lfoyx
餛	wpjx
攗	rynoa
頁	dmuq
㐫	ybk
雧	wyws
璤	ggjn
郝	fob
鰖	qodez
㝞	pgfg
镴	qvln
騂	cuhp
鑱	qqkyz
覺	vqqq
㻉	ghit
䋫	xqvh
龜	txd
㨮	rqrq
䲬	wvga
膴	erlo
鮚	qofk
鸡	cqy
䧸	dwygm
酅	mwyb
噍	kwyo
圗	lcfd
㑊	wyoy
覥	mawq
䴤	ynjgt
鴘	cawo
駒	cqkg
鴸	riwo
曟	jjjev
杂	vs
䪵	ahtm
軴	lygg
狰	qtqh
㾟	uhie
䋞	xmqq
塵	ynjfc
䪏	nhkw
䗌	jjtg
䧱	vwyg
龲	龲
㭲	swwks
䌗	xrlo
削	iej
讂	yqmt
䣷	sgri
赝	dwwm
閘	ulkb
㪲	ufnb
㨗	rhvh
雞	exdy
鯎	qodtv
䫳	lqjm
錬	qgji
截	faw
纙	xlxy
㣯	tnie
韠	nhkfg
魵	qowv
㝆	bfkk
捈	rwty
張	xdey
齌	yjou
螊	juvo
鲺	qgn
䪾	dmwe
䳦	pgjo
悇	nwty
㭎	smqy
䨉	mmvy
崤	mqde
鹏	eeq
櫌	sdet
䡈	lqqyb
猲	qtjn
䲊	qobe
筬	tdnti
蝑	jnhe
䚟	qejf
䈲	ttec
鸻	tfhgl
㺣	qtha
欋	shhy
䮛	cbwf
難	akfyc
暐	jnhht
猣	qtqt
髉	mepy
笙	ttgfp
浴	iww
䝓	evln
濓	iuto
离	yb
綠	xxgi
䯗	mexf
陋	bgm
䕶	aywcj
騬	ctux
閗	uufk
䃛	dlpy
娍	vdnt
顐	pldm
櫰	syle
鮞	qodjj
酁	qkxb
嵼	mutg
魨	qogn
㯥	gjiix
轒	lfam
騜	crgg
欺	adwwo
鮐	qockn
鱈	qofv
絊	xsggw
䵳	lfojz
㱈	ssfw
壹	fpg
䭖	wyvox
挶	rnnk
爂	vmgos
娋	vieg
鱘	qovf
䱸	qovcn
鷿	nkuom
揿	rqq
搽	raws
鑴	qmwk
䥏	qtrb
棥	sqqs
㩬	rhaa
㱂	yviw
轻	lc
䈰	trie
殳	mcu
戥	jtga
輂	awlj
靠	tfkd
鑈	qgwq
悂	nxxf
寪	peto
皈	rrcym
惝	nim
紎	xdy
傛	wpwkt
䳕	ebwo
䵄	swwu
壆	vqqf
綳	xeegj
琪	gad
䥿	qrdn
䮕	cccch
靊	fdhu
殽	qdec
䘡	xxye
昄	jrcyj
鴶	fkwo
稌	twty
鮁	qodc
骰	mem
餌	wpbg
蹓	khql
䫡	uvom
欑	stfm
瞻	hqd
剸	gjhj
輼	ljlg
飕	mqvc
釂	sgef
軸	lmg
鷓	yaoo
溆	iwtci
礖	dvgw
篱	tyb
譨	ymae
馳	cbns
㬭	jelf
膂	ytee
缼	rmqw
瘒	uplk
稴	tuvoy
鹫	yidg
鶨	xewo
鷁	uwlo
罓	mqi
桄	siqn
搈	rpwkf
䔪	adqq
䉖	tlwc
㡧	mhpu
骔	cpfim
鸧	wbqg
䲓	qoww
輠	ljsy
腳	ewwb
鯌	qotkb
剆	yvcj
桺	sgany
皆	xxr
鳊	qgya
撕	rad
锴	qxx
䥨	qukk
在	d
艪	teqj
䱐	qoeb
雛	qbty
䟸	khqa
鄮	qyvbd
蒓	axgn
䙚	tvge
蝔	jxxr
㫁	xxgra
嶌	mwvoo
傔	wuvo
䲅	qofq
爔	ougtq
臹	gcft
唖	kgkg
頚	cfdm
騟	cwgj
徕	tgo
䦍	utnv
臜	etfm
寴	pusq
熘	oqyl
愷	nmgu
闖	ucio
蓡	aivc
轥	lauy
铩	qqs
㯯	stam
䑂	evgw
宧	pahh
玙	ggng
痎	uynw
靜	geeh
欯	fkqw
郻	hnvb
磔	dqas
毘	lxxb
汚	ifnn
劆	yuvj
灈	ihhy
猚	qtwy
夀	fnkf
䦞	uigd
瑕	gnh
硄	diqnp
鞩	afijn
㿕	uuqvf
蠠	dmjj
闁	uudw
鶞	rfho
歑	hatw
㦁	lpnu
薝	aqdy
廒	ygq
䫃	dfem
覬	mgkq
唂	kwwk
骒	cjs
鮨	qoxj
诰	ytfkh
䏴	eieg
馉	qnme
页	dmu
轉	lgjf
騪	cvhc
鬚	deem
䡽	ltfm
䌟	xnku
閐	utfn
硋	dynwl
嵨	mwno
䥟	qrjn
綷	xywf
曱	jhki
鰋	qoav
䭣	wyvj
殻	fpmc
䍱	udwt
䳓	ftxo
㒗	waffp
槩	rxas
鎥	whtqs
轝	vgnl
籣	tugi
羋	gkghn
䔛	axdm
䚛	qetk
噟	ywwk
仳	wxx
不	i
麤	ynjx
赈	mdfe
䰳	qosh
䛀	yrcy
紾	xwet
奤	ddmd
煁	oadnz
莵	atkyx
嬼	vqyj
饞	wpqy
禰	pygq
䲸	wjwo
賅	mynw
棋	sad
䮭	cehq
䋗	xahhq
閿	uepco
鹵	hlou
編	xynau
䊮	onwy
梾	sgoy
桀	qahs
脈	erey
悶	unid
癬	uqod
脃	eqcn
㹹	qtywd
䨇	wywc
䗅	jdey
璇	gyth
㪇	tfqt
馶	cfcyd
䱃	qorw
衢	thhh
魪	qowjc
蓮	alpu
蠞	tvcj
澱	inac
掍	rjxx
鏩	qlrh
跡	khyou
㔖	lknbk
魯	qojf
鐣	qipr
鎧	qmgu
㟦	mplj
栬	sqcn
輽	lcdl
忂	thhy
䯐	memw
䀈	vcal
䘰	putp
耯	diac
鳻	wvwo
闂	uudb
旅	ytey
䱖	qogny
䐊	ejxx
閪	usd
滟	idhcg
襺	puaj
蠊	jyun
鐧	qujg
璫	gipl
㴔	iqvn
㦅	naqh
璘	goqh
䚥	qexu
襇	puujo
頸	gvam
椹	sadn
飣	wpsh
㺜	qtme
䦙	uffi
裦	yqge
堖	fvtq
漟	iipf
讆	tnhy
钁	qhhcl
䳉	tuwo
喕	kdmd
與	vgnw
鴴	tfho
魙	ilrc
裕	puw
觉	ipmq
韏	udnh
骁	catq
刀	vn
攪	rvqq
㘰	fufhs
鯜	qouv
鏙	qmwy
唧	kvcb
䝃	gkuo
蠙	jpgm
鵢	tmdou
䁽	hvln
纓	xmmv
㠌	madw
卿	qtvb
乆	nwi
尯	dnqb
覱	lrhq
澖	iusy
鰷	qowsb
䜾	gkujx
䍏	mjgd
餡	wpqv
剰	tgajh
髩	degn
饲	qnnku
飖	ermq
鱹	qoay
习	nu
除	bwt
蘻	albi
䮰	cumd
肷	eqw
巅	mfh
䍟	lqbt
妻	gv
條	whts
儯	wudc
詾	yqqb
磷	doq
筡	twtu
準	iwyfn
蛛	jri
鹮	lgkg
炈	omcy
鳚	qgnf
開	ugak
鲎	ipqg
筝	tqvh
娻	vgji
歉	uvow
鳴	kwvo
鍻	qjqn
闚	ufwq
閻	uqvdr
劾	yntle
谦	yuv
觙	qeey
䧾	wfky
纔	xqky
觔	qelnn
消	iie
襹	pugx
鹹	hloyf
涷	igji
趦	fhuke
骼	met
霭	fyjnq
簐	tlqw
雡	nwey
孇	vwyc
抖	rufh
䂧	dqiy
髎	mene
淌	iim
獼	qtxq
靤	dmjnp
䳖	wvgn
響	xtyj
孒	bgd
䧴	fcwy
灦	ijxm
毕	xxf
濣	ifjfi
䃣	deto
鯖	qoge
䡊	lrcyb
騐	cwyn
㗣	kaqh
嚪	kuqv
背	uxe
鞯	afa
㒫	ghfq
焦	wyo
鶂	vqwo
糏	onie
鸰	wycg
㶌	ibxg
鳱	fwvo
鸍	gwmo
榌	snuh
䴟	ynjyw
䙮	puayt
橆	rlgs
䇁	pwqd
䆸	pwwu
鰐	qokn
澢	iipl
䛜	ytlq
紴	xhcy
㠘	mvgwd
㩮	rvgr
䗲	joqhx
緷	xplh
㚃	fpqu
餉	wptk
箟	tjxx
笅	tqqu
熑	ouvo
䪙	nhkfm
䱀	qomd
䎤	dink
讎	wyyy
䒝	aqquk
缅	xdmde
瘝	ulii
嬊	aukv
騾	clxi
䋠	xgey
宪	ptf
梢	sie
顗	mgkma
顄	bibm
䄖	pywjt
絡	xtkg
㩁	rpwys
嘡	kipf
颦	hidfn
㔇	wxmj
垱	fivg
愖	nadn
纆	xlff
蹡	khnf
䆭	pwlf
荐	adh
鯀	qoti
骏	ccw
騲	cajh
㙪	ffpu
䚨	qewc
骟	cynn
擳	rtvb
㘩	fxxn
㩺	xxfc
溤	icy
旓	ytie
軩	lckg
壷	fpkg
絿	xfiy
䩉	dmjy
鳁	qgjl
繘	xcbk
囏	akfk
鱜	qoxb
蕥	aahy
傸	wdqqr
䃹	dugi
麍	ynjqw
㦃	nutg
䌒	xynx
㮣	vcas
曤	jfwym
蒤	aiwt
鏄	qgjfp
㐧	ynht
荼	awt
㴿	isdm
轇	lnwe
鹷	hlocb
鐁	qadr
洈	iqdb
䝪	mnhy
墢	fwxc
鮅	qont
谘	yuq
櫷	stmg
峥	mqv
䆲	pwyi
觲	qeuhn
䊶	xbn
蟕	jhxe
侸	wgkuu
顶	sdm
䂄	hhhc
䲣	haqt
蠐	jyjg
北	ux
嚵	kqky
囙	lnd
鳉	qguft
輇	lwgg
舝	nhvh
䭷	ctfn
邇	gwmp
鴮	dfno
䜃	ywyf
㲵	rnie
軡	lwyn
䢬	epqp
㻮	gqfi
烍	otfqn
㮓	sngg
隷	ffii
觘	qeit
㫉	yqdb
輩	djdlw
統	xycq
鯠	qosw
䊿	xfwy
腼	edmdx
豈	mgku
糇	own
幨	mhqy
煞	qvt
䦗	utld
飅	mtjl
㦖	nuny
譽	vgny
嚯	kfwy
軧	lqay
㬾	atde
姓	vtg
輋	mdlj
輅	ltkg
虛	hang
遁	rfhp
舉	vgnh
擾	rdet
䌱	xynyn
䉑	trlo
鷇	fpdc
䭞	wyvfk
擋	ripl
䡜	lfwf
讚	ytfm
丝	xxg
薡	ahnn
歠	cccwm
䥓	qadf
檫	spwi
餖	wpgu
鑌	qpgm
䉳	tqod
䲟	qgqb
絪	xldy
鷂	ermo
䭛	wyvth
轢	lxrs
䳅	wvgwh
瓕	xgwyx
鸆	hako
㒺	muwn
頬	guwmx
輺	lgvl
捸	rviy
偕	wxxr
懗	nfoo
冀	uxl
樘	sip
鑊	qawcv
設	ymcy
赭	fofj
蓐	adff
鮟	qopv
䌡	xmau
䑞	aooh
闀	uawn
櫅	syjg
䒽	amqq
䦚	utdd
領	wycmb
鱍	qowcf
䠾	tmdwl
鳐	qgem
䐓	edmy
鑭	qugim
䮗	cmdf
鬣	devn
壺	fpfg
鼱	vnuey
瑹	gawt
飭	wptl
鮙	qongj
䔚	adfe
寃	pqky
驴	cyn
燃	oqdo
䯍	mewc
匃	qwnv
䂚	dqqy
禽	wyb
儸	wlxy
岅	mrcy
爣	oipo
滦	iyos
贕	qytm
甉	uvon
䱿	qolr
颛	mdmml
斲	anjr
詹	qdw
䋲	xkjn
肶	exxn
郷	xtvb
搟	rlfh
褏	yqgeb
㲶	rnho
䅽	fnmt
呕	kaqy
䫵	thpm
憠	dubn
䮧	fjwc
鼤	vnuyi
㸃	lfho
㗴	kueg
詤	ywnq
翵	nwvoj
鏵	qagf
㚸	vngk
憷	nss
穗	tgjn
䃏	djtg
秭	ttntn
衡	tqdh
蒑	arvc
䚔	pgiq
櫯	sqot
駤	cgcf
麘	ynjj
飫	wptd
婫	vjxx
薠	aodmk
䳗	wvgtx
飥	wptae
哔	kxxf
㟻	lrmj
鸢	aqyge
党	ipk
䈴	tuvo
劁	wyoj
馀	qnw
獒	gqtdo
軼	lrwy
䧿	ajwy
儊	wssh
幠	mhro
䫮	vakm
攢	rtfm
浢	igku
灑	igmx
䈖	ttuf
㺉	fpgcr
变	yo
擊	lbmr
蘇	aqot
躜	khtme
鈠	qmcy
㮰	stlx
欩	vkqw
㯏	fnms
斆	vqqt
䭨	wyvk
傂	wrhm
鲦	qgts
焃	ofoy
媻	temv
顣	dhim
飮	wyvwh
䌉	xlgh
閖	uiic
護	yawc
駔	cegg
䦎	ufqv
䗶	jajn
骦	cfsh
鹞	ermg
䋐	xant
閏	ugdr
馻	ccqn
䒖	anfj
鳑	qguy
燬	ovac
鷤	kkjo
鮲	qowdk
碬	dnhcx
词	yngk
䡗	amyl
運	plpk
㙰	qevf
嬿	vauo
鱦	qomv
侁	wtfq
颏	yntmz
櫀	sadi
䱎	qoggx
癅	ugal
寯	pwym
蟴	adwjj
罼	ljaf
察	pwfi
虅	aeuc
鹋	alqg
鴆	pqwo
螿	nhdj
頉	hdmy
獮	qtgqa
䊲	soug
骕	cvij
䌑	xahf
頏	ymdm
鹦	mmvg
㴻	igkf
蓣	acbm
欼	cccw
籫	ttfmg
扻	rqwy
繒	xulj
鶲	wcno
䏅	bwfiy
簏	tynx
斣	lqjf
嵑	mjqn
賑	mdfer
籁	tgkmi
䡨	udal
牿	trtk
䫥	rqcmi
慷	nyv
䌦	xnwyp
級	xeyy
駧	cmgk
䈝	tnheo
䨆	umiy
髄	medp
姬	vah
鍡	qlge
毚	qkxy
雐	hawyj
駑	vccu
爲	etno
駲	cyth
鼇	gqtv
綟	xynd
閸	ugfg
絕	xvcn
㶒	iucy
鷯	dujo
蠜	sqqj
夕	qtnyg
榾	smeg
䦬	udhd
䰼	qownr
鱷	qogk
璭	gplp
㛓	vqdh
䬛	mtjfs
綉	xten
軬	cdlj
颓	tmdmg
祩	pyri
顱	halm
乖	tfu
筶	ttfk
㥿	gqtn
踓	khwyp
糭	oobt
佽	wuqw
蔱	aqsc
䉮	tuwyi
鲀	qggn
懰	nqyj
逄	tah
龊	hwbh
嫻	vusy
鵬	eewo
紃	xkho
㬞	jmjn
雅	ahty
杀	qsu
澔	irtk
鰟	qouy
碁	adwd
硇	dtl
軽	lcfg
軫	lwetn
䚫	ryte
䙍	punhh
綺	xdsk
䋹	xgkl
常	ipkhm
躎	khgq
䮦	cymk
䔥	avoj
癃	ubtg
鍭	qwnd
㦇	nynx
潱	ifpu
幌	mhjq
骨	me
巣	ijsu
閒	ued
䍍	fpgcx
黑	lfo
翟	nwyf
迎	qbp
祲	pyvc
冕	jqkq
䪼	bmdm
㧪	rqdb
鑹	qpwn
踸	khany
䣅	dfeb
蔸	aqrq
欨	qkqw
鶆	swwot
饛	wpae
煆	onhc
緡	xnaj
絵	xwfc
煋	ojtg
醑	sgned
輬	lyiyv
墱	fwgu
䋱	xsww
㶕	ituj
鹳	akkg
鸜	hhwo
徐	twt
汛	inf
欁	smas
騌	cpfi
沘	ixxn
餳	wpjr
鱲	qovn
卤	hl
遬	gkip
臁	eyu
蝋	jimh
蠒	gwmj
䪌	afqyt
䍞	mqqg
橍	sugg
䋏	xthf
䈾	tsie
喚	kqmd
㺘	qtwo
䡪	lynnu
龸	龸
墭	fdnl
鹊	ajqg
㮞	suqk
䝉	opeu
驘	ynky
閬	uyve
藋	anwy
䡁	tmdds
頮	iadm
䱷	haqtn
鸪	dqyg
饌	wpnw
獩	qtht
綀	xgki
噜	kqgd
躐	khvn
雟	btwk
蠪	uegj
硝	die
㿦	fnmrn
䵜	twie
䕠	aywc
輸	lwgj
鯸	qowd
䵪	lfoxb
醌	sgjx
䴅	famo
骊	cgm
輆	lynwi
幤	imkh
餴	wpda
鰂	qomj
骃	cldye
韜	nhkv
凱	mgkm
霤	fqyl
靨	djedy
劏	ipkj
䋚	xngy
䐍	efku
絴	xudh
䋘	xdiy
鼣	vnudp
觼	qeqt
痶	umaw
滩	icw
㡙	mhtx
耰	didt
伇	wmcy
瘶	ugkw
竭	ujqn
侯	wnt
䨼	geac
燁	oagf
殷	rvno
㦛	vgnnh
蔕	aaqh
碷	drfh
䭀	wyvp
鮊	qorg
繶	xujn
䜅	ymwyd
癇	uued
車	lghh
宺	pkgq
僶	wxg
鐮	qyuo
綱	xmum
綾	xfwt
佹	wqdb
擦	rpwi
麑	ynjqa
缡	xyb
骤	cbc
蹨	khqo
紞	xpqn
㰚	syby
轏	lnbb
猳	qtnc
乜	nnv
遝	lipi
䲧	fwvoe
謦	fnmy
擟	rgwq
䃧	btgd
鸇	ylko
㥆	nviyp
铖	qdn
皭	relft
䯇	meln
駸	cvpcm
蔄	aukf
袸	pudb
緸	xsfgs
肖	ie
烗	oynw
軏	lgqn
㰟	rnqw
斵	qyvr
攋	rgkm
鯶	qopl
碣	djq
䭻	cwvn
偱	wrfh
䃈	dxxr
躧	khgx
䯔	mepa
㫟	jmkg
嚇	kfoo
䡤	ftjl
悪	gkjn
覵	uehq
稰	tnhe
歍	wngw
䡆	lwcy
鱸	qohlx
籋	tgwqr
㺢	qtfy
鴻	iawo
皩	rgjq
鲗	qgmj
軖	lgg
㛒	vgku
晪	jmaw
颊	guwm
颃	ymdmu
驕	ctdk
飳	wpyg
荿	adnt
蔛	aqef
㜬	vqdy
夓	vdht
䄞	pywi
騎	cdsk
缿	rmrk
愇	nnhh
頯	qadm
猥	qtle
慚	nlrh
唓	klh
䬯	wyvkg
䑾	tewc
繃	xmee
甡	tgtgo
殸	fnmc
䫢	rhamg
㵯	imdo
㡫	xjqnj
䩆	dmjf
廐	yrxq
噎	kfp
譡	yipl
䲂	qoyhy
轋	llpy
緑	xviy
輙	lbcy
僞	weto
埐	fvpc
潿	ilnh
遨	gqtp
駪	ctfq
鎸	qwye
儺	waky
紨	xwfyq
䝈	ergb
䓇	afou
栍	stgg
暒	jjtgh
㗇	knhc
卮	rgbv
萁	aadw
毉	atdw
䳬	afwod
醀	sgwy
﨟	aejn
繪	xwgjq
怷	fqynd
鱏	qosj
蓠	aybc
颇	hcd
磆	dmeg
樭	sadf
頹	tqdm
惱	nvtq
㕑	dfkf
滐	iqas
縁	xvey
璛	gvfj
滑	ime
㿚	ulxy
纜	xahq
轐	logy
鯱	qohm
㵧	iajn
韀	afyof
甦	gjqg
潤	iuggk
燋	owyo
䋍	xskg
邬	qngb
雍	yxt
襯	puuqc
絸	xhqn
儱	wued
魿	qowc
竲	uulj
刹	qsj
鲘	qgrk
蹸	khoh
㘳	uxff
騮	cqyla
潣	iuyy
蓉	apw
䕣	apun
濔	igwq
鯫	qobc
䱦	qowyb
頡	fkdm
㷼	aukoq
馴	ckhf
隲	bitc
臇	ewym
㠦	mdhu
阠	bnfh
頜	wgkmc
熙	ahko
先	tfq
躙	khuyn
䪸	nadm
㰷	gqxw
繻	xfdj
䞛	fhgn
讗	ymwk
㬨	jfoo
䡌	ldcyp
䫟	kmdm
巂	mwykf
㵶	ifay
鵜	uxho
﨩	bwvm
嘗	ipkju
㜞	lrvf
鎞	qtlx
䌄	xgmc
鮤	gqjos
鐑	qxfk
厃	qdr
欰	tlqwm
騨	cijf
䬼	wvye
撫	rrlo
㱿	fmgc
羐	gjgy
纑	xhal
瘻	ukgv
㬹	eqvh
稏	tgfg
鶒	gkio
礍	dajn
觶	qekf
䍢	lrlo
䅿	tagf
鼳	vnudb
赬	fohm
納	xmwy
䄜	pyyc
㱍	xyxwq
䡲	lkkfh
躩	khhc
綎	xtfp
欭	ldqw
觞	qetr
径	tca
䮥	cgkh
鲡	qggy
誵	yqde
繸	xuepb
獣	ilgd
擢	rnwyr
睐	hgo
䥃	qpwy
㰳	gfgw
奪	dwyf
䱕	qotu
色	qc
䮟	cpoc
璒	gwgu
襾	gmjg
䆴	pwqnw
飶	wpnt
㩋	rvfj
撨	rwyo
隚	bipf
䩊	dmjb
權	sakyw
㜛	vlqw
毼	jqwna
樹	sfkfk
燕	au
鵪	djno
骑	cds
歖	fkuwo
踄	khhi
優	wdet
虒	rhamy
夬	nwim
埏	fth
郖	gkub
䫍	djdm
㩅	rgjl
儐	wpgm
蘒	atqn
玈	yxte
姊	vtnt
䫀	vcdm
薈	awgjv
闊	uitd
窵	pwwof
釁	vmgv
蠘	jfay
蕤	aetg
䦝	ufoi
泼	inty
䄈	pygu
桭	sdfe
晚	jq
㯴	sapk
讋	uegy
冁	ujfe
㵗	uciu
爳	etnb
縤	xgxi
顋	lndm
洍	iahh
瀤	iyle
瀀	idet
途	wtp
噽	fkug
臀	nawe
鮀	qopx
鸴	ipqgo
僱	wyny
鷷	usgo
懶	ngkmp
瀄	itvb
疍	nhjg
㾾	uuvo
睌	hqkq
撀	fnmr
䁠	huvo
霽	fyjfa
嵽	maqh
祢	pyq
叏	nhcu
䮀	cqnn
壭	fbj
輧	ltff
䁩	hqoy
䯈	mefqp
翬	nplj
紋	xyyl
纖	xwwg
㨥	rxmw
孩	bynw
擯	rpgm
鱧	qomu
帟	yomh
㷃	odeu
毞	xxtn
冼	utf
嚓	kpw
䌔	xakku
䲳	ymwo
簷	tqdy
闝	umti
軗	lmcy
輝	iqpl
镗	qipf
騳	ccy
䱤	qoqv
焔	oqhj
滶	igqt
貹	mtgg
雚	akky
钨	qqn
騊	cqrm
緻	xgct
鷑	tuwoo
䮍	cyeu
輹	ltjt
力	lt
瀔	ifpcs
䗨	jqoye
薣	afkc
欆	swyc
欔	shhc
呜	kqng
癩	ugkmy
䌍	xakgu
䌚	xsoy
穪	tgwq
鬸	gkml
璺	wfm
餎	wptkp
䭏	wyvaq
䴙	nkug
璽	gwmy
笓	txxb
䁗	hmgu
馸	crh
攆	rfwl
舭	tex
瀩	itmm
冎	mnmb
䔾	arjn
尐	iyu
尡	iqjx
撊	rueg
襰	pugm
庇	yxx
觗	qeqa
䤁	sgan
逌	hlnp
溗	itux
赨	fojy
㵐	iduw
㙭	fduw
䗸	yxtj
䌢	xfwc
鲓	qgfn
鶴	pwyo
趀	fhtt
擻	rkgt
爵	elv
㒜	wvgw
邆	wgkpq
穛	twyo
䲮	fqwoj
奮	dwyl
繂	xyxfz
騢	cnhc
榴	sqy
䫷	gkkm
嘏	dnh
蠽	iwyj
鴕	wvgx
僴	wujgr
鍆	qugn
籞	ttri
鵊	dwwow
緱	xwnd
鹀	awwgc
鎩	qqsc
蛧	jmqq
燐	ooqh
悆	wtnu
簢	tuyu
䉲	txgqa
連	lpkt
騖	cbtcj
藨	aynoe
灃	idhu
鮧	qogw
䏤	engk
呉	kngw
龈	hwbe
㘚	kunt
蝜	jqmy
澥	iqeh
鶅	vlwo
莦	aief
䡸	lalt
䡛	llh
飼	wpnk
寝	puvc
闤	ulgez
顓	mdmm
斞	vwuf
斬	lrh
鯉	qojfz
鷉	rhao
欷	qdmw
塈	vcaf
爖	oued
贅	gqtmv
危	qdb
䴆	oguo
科	tu
駰	cldy
㭡	stlq
巤	vlqn
闟	uwgn
鳙	qgyh
齎	yjmu
廡	yrlof
䨃	jpvy
挡	riv
鯗	udyo
垓	fynw
轎	ltdk
韘	nhksp
鲫	qgvb
鶾	fjwo
興	vmgw
狶	qtqhw
㒄	wqdo
壑	hpg
䚿	yqwy
驎	coqh
龔	uegw
䯉	meqw
搋	rrhm
瀳	iayo
慤	fpmn
鰆	qodj
应	yid
鎯	qyvb
蘏	axfm
纇	oximw
雙	wywcz
栾	yos
澩	vqqi
輨	lpnn
䗮	jdqq
锟	qjx
釒	qtyg
欪	bmqw
囬	ljfd
眍	haq
鰢	qocy
瞃	hrfh
藇	avgw
䡱	lakk
珖	giqn
駉	cmkg
鳨	wvgl
㺞	qtvw
㱃	wynws
铣	qtfq
箕	tad
譝	yxg
䆂	tyuoi
櫇	shcm
籨	twgwe
没	im
皓	rtfks
綐	xukqq
曜	jnw
㱋	fwyw
崢	mevh
哅	kqqb
赥	foqw
嚣	kkdky
翭	nwnd
尌	fkufx
飤	wpwyt
䧞	bcy
恋	yon
洉	irgk
鏸	qgjn
絉	xsyy
䴕	gqjge
犊	trfd
鍖	qadn
㵰	ivgw
廽	mjdp
䌴	xyny
顒	jmhm
䞾	fhrm
穭	tqoj
巇	mhaa
栥	uqwsl
顭	alpm
觸	qelj
妳	vqiy
䡻	lthy
䌥	xean
辄	lbn
雇	ynwys
鴒	wyco
駛	ckqy
縃	xnhe
顮	pgimo
擬	rxth
磭	ddfe
叙	wtc
橲	sfkk
豷	efpu
觻	qexs
䡒	llgo
蘓	atqo
罹	lnw
駡	kkcu
䌪	xuqv
翴	nlpy
跦	khri
嫌	vu
嶐	mbtg
㫎	ytpl
銸	qbnn
堊	gfgf
惡	gfgn
尹	vte
鰗	qodey
軎	gjfk
畏	lge
䠖	khukh
籎	txth
璔	gulj
鳥	wvgo
鎤	qjiq
嶁	mkgv
厰	dimt
䦌	ufdz
偎	wlge
鋔	qqkq
㺷	gsyy
賴	gkimk
鳀	qgjh
䱥	rmho
騹	cakgw
㲄	fpgcm
谯	ywyo
肀	vhk
譌	yeto
㦺	dfea
睜	hevh
鄥	wvgbr
鵄	gcfo
琟	gwyg
彏	xhhc
㶠	iclf
䞺	fhrh
䒏	uljc
銮	yoqf
㦤	fpgnf
嚬	khim
毗	lxx
䧽	towyb
餜	wpjs
鲈	qghnu
椴	swd
櫬	susq
龡	wgkw
㡓	mhpl
鵎	evwo
檰	sxrh
蜝	adwjn
鱪	qojjf
瀾	iugi
㿣	rjqn
擓	raiy
傌	wcy
錷	qlnn
諢	yplh
鸯	mdq
䫣	exdm
䱱	qouh
繋	lmci
檎	swycj
嵙	mtuf
吳	kndu
䴚	hlom
猕	qtxi
檔	sipl
輜	lvlg
乲	uqwns
䥸	xgwqk
䢝	gfgp
㻣	gadn
嶱	majn
瓏	gued
囃	kywyh
㠛	mawc
䜁	yffd
䪗	nhkcu
毂	fpl
窶	pwkv
麇	ynjtu
次	uqw
瓇	gdet
欱	wgkwf
嘄	kwvs
嶙	moq
鲽	qga
顷	xd
鷦	wyoo
朗	yvc
琧	gfgy
絋	xycy
輦	fwflw
軨	lwyc
噓	khago
䑟	epqg
龑	uegdp
䃾	pyxx
髇	meyk
啮	khwby
撶	ragfo
弑	qsa
綞	xtgf
琿	gplh
唯	kwyg
䦨	ugjiz
䡚	lrqn
綩	xpqb
䪛	nhkl
隴	bued
悽	ngvv
蔜	agqt
軲	ldg
檲	slgf
嵥	mqas
搀	rqku
熀	ojiq
顢	amhm
鮫	qouq
題	jghm
徦	tnhc
畡	lynw
魱	qoggz
鵣	gkiop
霯	fwgue
混	ijx
鲚	qgyj
䱍	qoggy
㐸	wqwy
橺	sujg
簍	tkgv
嫣	vgh
㝚	pthp
軚	ldyy
焜	ojxx
㔸	arhm
鮆	hxqo
戵	hhwa
轊	ldhv
鰱	qolp
薾	agwq
鲾	qggl
㰍	uegs
㬇	jqmd
鼠	vnug
鹶	hlon
轟	lllj
蘉	alpce
浼	iqk
絣	xuah
般	tem
㽔	oetg
餈	uqwe
鲛	qguq
穃	tpwky
䖙	ahnm
诟	yrg
鴷	gqjor
㓥	ivjh
镰	qyu
邋	vlq
頙	ghdm
弰	xieg
䳽	mwyo
歈	wgew
刄	vyih
䱳	qodf
鬬	hggr
鷙	fufo
恼	nyb
盾	rfh
镳	qyno
稦	tnhhk
䫕	upmm
鯭	qobl
蛫	jqdb
鳜	qgdw
丏	ghnn
駨	cqjg
蕑	auef
鼒	fthn
鑁	qobt
䒊	wgnc
矙	hunt
岚	mmqu
穫	tawc
桅	sqd
鰹	qoaf
觯	qeuf
㸍	ohaa
蓹	atrb
饅	wpjc
橚	svfj
騘	cqrn
䋭	xyce
䭦	wyvfq
殅	gqtgv
憉	nfke
斠	fjgf
囍	fkuks
䪜	nhkyf
崅	mqeht
䌳	xgwy
麕	ynjtv
誕	ythpn
繀	xmwym
襻	pusr
閣	utkd
鶧	amdo
卯	qtbh
熔	opw
甐	oqanx
䣚	lvbh
埩	fqvh
瘬	uxde
廊	yyv
㾻	ubwt
绱	xim
襍	puws
䮅	cant
驜	cogw
黩	lfod
鹸	hlow
鯾	qowq
巌	midt
鸬	hnq
聯	bxxg
新	usr
鶐	sypo
卍	hghn
鱆	qoujn
馯	cfh
䜛	yqkq
湝	ixxr
櫈	swgm
饄	wpif
鴋	ywvof
㨌	fprc
歲	hdgtd
髒	meaa
䴓	gmhgb
䱝	qorf
鳎	qgjno
縖	xpdk
魜	qowy
韖	nhks
鶦	dewol
瞴	hrlo
徜	tim
駟	clge
剴	mgkj
䯥	mejo
欝	sqqfl
䲍	teuo
藧	axec
䕻	agmx
䒭	anfu
繡	xvfjr
哧	kfo
鲨	iitg
緮	xtjt
蝦	jnhc
䮲	camw
檙	shnn
閽	uqajl
僘	wimt
䯣	mekm
䋊	xghg
倠	wwyg
䮺	cyjg
歏	akgws
磡	dadl
槫	sgjf
䡖	lgwf
層	nulj
頴	xfim
㖃	krgk
崃	mgo
灘	iaky
㴸	iuwy
㺅	qtqd
䦮	udwj
㒞	wmwm
雉	tdwy
䀭	hynw
吗	kcg
趙	fhie
蝀	jgji
欽	qqwy
騗	ynmc
亷	utvo
鸃	wvgtt
䧰	bqoi
簦	twgu
䴍	mmwoh
嘨	kvoj
梮	snnk
麷	swwui
俭	wwgi
㯿	svln
㯘	sffw
橖	sips
湦	ijtg
羯	udjn
鵸	dsko
夅	tahjt
媫	vhvh
蘤	areo
鵓	fpbo
赉	gom
韓	fjnh
鼜	fkuj
鬨	hggw
聺	bpwi
韕	nhkbt
䮬	cajd
缣	xuv
㐄	ahkz
逍	iep
擼	rqoj
㦜	nawc
懈	nq
搰	rmeg
潾	ioqh
当	iv
觤	qeqb
鸭	lqy
雀	iwyf
䪎	afmk
娯	vknw
䖀	akkk
兇	qbqb
㱎	liqw
喪	fkke
嚄	kawc
靑	gmhgw
鴩	rwwo
僫	wgfn
贚	muedo
䭜	wyvil
鯦	qotk
肅	vfjk
晠	jdnt
鴟	qayo
魚	qou
襅	pujfs
崋	mgaf
䫂	qqdm
鮻	qoct
頥	hahm
偉	wnhh
亾	wnv
䥎	qdfes
雒	tkwy
领	wycm
鯑	qoqh
䄵	tahj
䓙	atfx
鷼	ujwo
䤥	qqdb
㭚	stey
䠘	khtx
僌	wlty
䵷	ffxg
㭯	sbnn
䲌	qofw
㲱	tfnn
萇	adeu
䮼	cooh
䂃	helf
尳	dnme
桷	sqe
㘑	kffi
䕹	aywy
瀨	igkmp
翽	hdgn
歊	ymkw
䯻	detk
撑	rip
偼	whvh
閉	ufte
嘉	fkuka
鑋	lgvq
䏭	eriy
䖒	hagu
県	hniu
奒	dynw
朱	ri
鍁	qrqw
餯	wpxe
敎	qdbt
偈	wjq
糼	xln
籀	trql
骀	cck
纊	xyaw
跭	khthj
䈜	twvc
譋	yueg
竱	ugjf
礮	dcuq
糶	bmoy
䦯	ugct
捣	rqym
珗	gtfq
䪺	fcdmj
燢	vqqou
嵌	maf
龀	hwbxe
婙	vqvh
㯍	snhf
鮔	qoan
暍	jjqn
绉	xqv
寢	pnhc
泾	ica
驽	vcc
巉	mqky
團	lgjfc
㤻	qytn
摚	ripf
䚕	gmyq
絈	xrg
顳	bbbm
嫯	gqtvd
䔫	anhi
鬰	sqqe
熌	ouwy
矡	cbtcq
㮽	stec
獪	qtwj
㙗	flge
䦥	ussik
䳝	ukwo
鏇	qythb
䊐	ojxxh
敼	fkuco
闧	ufkp
薲	apgm
潅	irwy
䥴	qmwm
䳹	wvgcw
榹	srhm
萞	amwx
輻	lgkl
㼢	ahkn
掙	revh
髍	meys
沤	iaq
䤰	fqwq
豍	gkuf
写	pgn
儍	wobt
炊	oqw
聾	uegb
閟	unte
縚	xevg
﨔	siwr
籬	tyby
楖	svcb
颌	wgkmj
磪	dmwy
縂	xukn
䫐	ssdm
嬉	vfk
刚	mqj
觿	qemk
騔	cjqn
趯	fhny
㾶	umed
赤	fo
餱	wpwd
駐	cygg
苡	any
䞋	musq
㶝	iiyn
䭐	wyvnm
㝦	pwyeq
䣖	ckcn
澕	iagf
韌	nhkyp
鲩	qgp
鱮	qovw
膯	ewgu
鱽	qgvn
緂	xooy
澠	ixg
賱	mplh
権	srwy
螐	jwno
歆	ujqw
㩻	qdbc
鵟	qtgov
綻	xpgh
㟺	mlvf
役	tmc
劂	dubj
䑰	tehi
䗠	ytnj
齼	hbsh
熚	ojafn
茚	aqgb
嬥	vnwy
驡	uegc
㡣	upmd
卙	adwfx
鰬	qohy
韾	fnmj
䮿	cpfh
䵶	qkxg
䣳	sgnk
䚏	oqaq
䱴	qongc
瓷	uqwn
䛦	ywwka
蕷	acbmx
間	ujd
綏	xevgp
褩	teme
輱	ldgt
蹥	khlp
藗	agkp
巯	cay
蚪	jufhw
㿀	ugyg
䞓	foga
焀	owwk
鵨	wfko
㗫	kwfi
䕵	afko
䮴	cwgu
籰	thhc
鲧	qgti
豀	wwkdg
骡	clx
蕟	awxc
紭	xxcy
䬵	wyvw
矘	hipo
槃	tems
覛	rehq
莬	aqkq
䱛	qoag
瓒	gtfmu
瑿	atdyy
㤆	nrcy
廢	ywxc
䃆	dadw
鲋	qgw
漋	ibtg
飴	wpck
趰	fhgq
躼	tmdep
璃	gyb
斯	adwr
鼖	fafc
槜	swye
鼕	fkuu
㲋	qkxx
溓	iuvo
珄	gtgg
鐬	qhdt
鲲	qgjx
鹆	wwkg
龕	wgkd
厳	idntw
颔	wynmg
颅	hndm
朅	fcjn
䋌	xangr
撃	lmcr
欐	sgmx
嶲	mwym
鴦	mdwo
砓	dmcy
匷	ahhy
噲	kwgja
䦒	udd
涱	idey
宬	pdnt
臍	eyjg
麏	ynjk
柹	stnt
㮿	sjaf
㐙	gkunq
㠨	msqf
挣	rqvh
鯷	qojhp
䊜	ogjf
灧	idhc
设	ymc
孵	qytb
岛	qynmu
㘉	ktvb
鸹	tdq
襧	pugq
臢	etfmp
緝	xkbg
蘕	axtp
裋	pugu
軮	lmdy
鰄	qodti
漁	iqoyd
㽆	ipknr
鼫	vnuda
䰖	detm
犌	trnc
䦡	upnny
凃	uwty
洶	iqqb
㒿	jyby
帶	aqph
砒	dxx
灡	iaui
踲	khrh
鮺	udqo
蛮	yoj
欠	qw
㮌	sdmdl
澄	iwgu
瓎	ggkm
鳦	wvgng
眄	hgh
䜭	hpgk
虧	hawn
鮾	qoev
皸	plhc
䐨	fpgci
莈	aimc
鳏	qgli
䮈	cqqy
馹	cjg
閤	uwgky
㰒	svqb
襜	puqy
兤	iqyws
䳞	dwfo
閲	uukqt
㡗	mhrm
楎	splh
䢅	vdfe
蝍	jvcb
鳮	cwvo
釼	qvyyj
兼	uvo
灛	iukf
掶	ryvw
㒨	wvtn
䮌	cwsy
嗸	gqtk
燍	oadr
鸝	gmyo
䥥	quto
㴲	irhm
縳	xgjf
䒍	upyct
㼽	dqqn
懒	ngkm
碨	dlge
閛	uguh
骖	ccd
䁣	hgjf
嵗	mdgtq
㸈	wywo
蠄	jwyc
驄	ctln
鶣	ynmo
偿	wi
閾	uakg
䰣	rqcqd
虍	hav
弻	xglx
簵	tltkl
褐	pujnm
慡	ndqq
馨	fnm
荄	aynw
条	ts
矍	hhw
匘	xvtq
邾	rib
䡧	lwno
鱉	umio
凘	uadr
髖	mepyx
造	tfkp
輁	lawy
䴦	ynjy
狴	qtxf
乁	yyll
潍	ixw
幱	mhui
䎣	dinw
觛	qejg
雂	wynyo
䃵	dyce
婁	lvfn
瓁	gawc
幆	mhjn
㘭	fxnn
频	hid
絬	xtdg
䣃	rhbh
䋬	xgdn
䴞	hloy
㙄	fxxf
鼨	vnuu
滁	ibw
鰮	qoll
撅	rduw
留	qyvl
鳋	qgcj
㛂	vrcn
礸	dtfm
靆	ffcp
憴	nxg
亡	ynv
䶜	hbtk
㺶	gufh
販	mrcyp
䞈	meto
軹	lkwy
吺	kmcy
産	uttg
㢝	yqot
轜	lfdj
髅	meo
㤱	ngku
饍	wpuk
驷	clg
城	fd
駱	ctkg
㲊	hpgc
饘	wpygi
鮼	qovc
欲	wwkwo
䭢	wyvsq
逧	wwkp
䛥	yqdh
佥	wgif
鰜	qouo
紙	xqan
䔽	aijn
饭	qnr
䅙	tjxxx
駴	caah
䠆	khdeg
鍟	qjtg
乌	qngq
堨	fjqn
矛	cbt
鴓	ntwo
鶁	yiwo
鵞	trnoj
鼈	umiv
潗	iwys
薋	auqm
輤	lgeg
鏮	qyvi
醴	sgmu
赱	fuyu
鬝	deujt
笥	tng
縓	xdri
䴇	fwyot
凍	ugji
縧	xwhs
摪	rnhf
䎞	ftjnu
鍜	qnhc
诤	yqvhu
瀕	ihimj
蹞	khxmd
㸯	truf
瘾	ubq
闣	uipl
㤴	nbnn
戳	nwya
熣	omwys
駶	cnnk
繺	xqvo
鎃	qire
藹	ayjn
鸖	fwyoo
鱩	qofl
齊	yjfr
䨶	fchn
䍶	udgi
㭻	simk
婿	vnhe
緅	xbcy
㜕	vlpy
狳	qtwt
茪	aiqb
慶	ynjt
獎	nhddq
漣	ilpy
繍	xvoj
㵌	itrh
䫠	egim
悵	ndey
䋔	xgig
揩	rxxr
䮙	cakg
慿	ughn
顜	fjgm
㱾	yntc
篳	tjaf
駼	cwtyg
㷎	ojqn
增	fu
龏	uega
逅	rgkp
結	xfkg
灁	iuri
単	ijfj
瑖	gwdc
鼲	vnuly
縍	xupy
鯳	qoyyc
鑃	qnwyx
飽	wpqn
頺	tedm
鱋	qohg
鳺	fwwo
胷	qqbe
䮻	cfnf
䛩	ygfg
蘿	alxy
顸	fdmy
範	tlbb
题	jghmt
䅡	tdmy
䶁	fkuje
㧣	rriy
酙	sguf
䶬	ffud
敍	wthc
然	qd
鷝	jafo
縸	xajd
㙶	yipf
莺	apq
㧨	rrgk
䨊	wywg
䦆	qhhc
㬠	jqvo
磵	dujgd
揕	radn
﨡	jtgg
毭	gkunr
㨑	rqbt
䗳	jwgu
㡠	mhwu
硲	dwwk
撸	rqg
尚	imkfw
䖘	hamy
䍑	mqqf
鳬	wvgmo
勉	qkql
紐	xnfg
你	wq
漀	fnmi
鲌	qgrg
緓	xamd
䆇	tmwo
䋙	xbg
骠	csf
㠊	mhag
㒟	wycew
䇫	tahh
渎	ifnd
恆	nghg
偭	wdmdk
揤	rvcb
噡	kqdy
䰿	qotbm
㸝	thgwo
㨝	rnieu
㜙	vynx
嵰	muvoa
䥧	qhph
鄇	wntb
摌	rutg
攙	rqky
鲟	qgv
蓈	ayvb
觖	qen
倎	wmaw
簌	tgkw
䳙	mgno
噅	keto
买	nudu
飹	wpqb
隹	wyg
龗	fkkd
烻	othp
雁	dww
䂂	hhhy
䬰	wyvkk
纏	xyjfl
鹈	uxhg
廗	yaqh
嵧	mqyl
躕	khyfu
脆	eqd
嗗	kmeg
篧	tpwy
傻	wtlt
䡡	lxxr
糉	oqbt
既	vca
鰵	txgo
鱇	qoyit
荜	axxf
崬	mgji
䦔	ujgd
獬	qtqhs
㼯	gjin
䰷	qodh
苝	auxb
魋	rqcyi
簯	tsaw
絢	xqjg
榇	sus
歒	umdw
䔇	amgu
䬢	wyvv
酽	sggd
縠	fpgcy
㷸	ojgfw
纀	xwoy
牚	ipkt
䵼	nhdn
歁	adww
幺	xnny
蝕	wpjy
蒦	awycl
携	rwyeh
䴏	auko
䤨	qrey
㜌	fpgco
䳇	xguo
斕	yugic
駍	cguh
給	xwgko
輢	ldsk
鵐	awwo
轖	lfwk
谽	wwkk
曕	jqdy
䱉	qoeg
䚘	tqehe
絽	xkkg
乘	tux
萧	avi
罵	lcu
顔	utem
鳒	qguo
亀	qjjn
䲯	eywo
鱗	qooh
塢	fwno
䅋	tqkq
褭	yceu
鱵	qottg
閙	uymh
歂	mdmw
疏	nhy
䴥	ynjkl
䟴	khdeb
㪱	yqmd
鯵	qocea
瘢	utec
䫏	adwme
薩	abug
䥾	qpgg
䋃	xtfn
晩	jqjq
䮣	cccs
襘	puwje
禠	pyrm
䪚	nhknl
蕭	avfj
㠏	magf
繳	xryt
輊	lgcf
騯	cupy
瀬	igkml
軷	ldcy
䶉	vnul
䕀	affw
璾	gyjg
繟	xkkf
愒	njqn
龥	wgkmk
毐	fxdr
䪿	tlqm
䮖	cjjg
噁	kgfn
労	iplb
赡	mqd
擕	rwym
鏎	qjaf
巑	mtfm
赩	foqc
䮊	cgxw
䊒	owyg
䆋	tqxg
慺	nkgvf
谺	wwktm
䳱	cbtoc
鉰	qngk
䴑	lllof
䥉	qpqy
趎	fhri
㱉	oguwt
廯	yqod
塅	fwdc
戼	angn
砜	dmqy
簹	tipl
㫈	ywuk
䯃	cpvg
䪝	nhkc
䕒	afkk
骇	cynwa
蠁	xtyjo
䭑	wyvo
聲	fnmb
睑	hwgi
鳧	wvgmh
娩	vqk
瓪	gnyc
縅	xdgt
麚	ynjci
獱	qtpm
㭸	sqky
铛	qiv
鑔	qpwi
䬫	wyvy
綰	xpnn
閮	utfp
殯	gqpm
雊	qkwyc
滷	ihlo
鹔	vijg
捿	rgvv
綘	xtdhn
䖚	hamoj
㯗	susy
㔢	xqcl
䮞	cdwj
艭	tewcq
穢	thdt
嵦	mmgu
糦	ofkk
頎	rdmy
馦	tjuo
䲠	qgdj
㺏	qtlv
䙟	pulh
霄	fie
瘕	unh
崐	mjxxy
䔮	aadrp
賾	ahkmm
莱	ago
㩲	rakyg
鵚	tmwol
餧	wptv
琑	gieg
絚	xghgk
䯪	ymkmc
䗢	jtfp
鶕	ujwof
䜵	gkuck
穱	telf
骚	ccyji
挄	riqn
鲄	qgsk
祃	pycg
粻	odey
璴	gssh
䫯	ydsm
䪖	nhktc
䴠	ynjda
涣	iqm
騸	cynne
䬡	ftjh
䮸	wfqc
䲐	qohl
鯝	qold
聻	ilrb
䩅	dmjce
騕	csvg
摧	rmw
竉	pwud
輫	ldjd
㒯	iqaf
驱	caq
熴	omjx
頵	vtkm
孪	yob
殹	atdc
傦	wmeg
総	xwcn
㐃	lhk
緯	xnhhm
靧	dmjm
䎫	diqt
绝	xqc
栙	stah
髊	meuar
藮	aswo
觫	qegi
䘱	uwke
褵	puyc
䶱	tutx
反	rc
噒	koqh
鯄	qofy
搫	temr
䳔	vwvoh
羻	udyt
鉳	quxn
騥	ccbs
俥	wlh
湾	iyo
歔	haowi
諮	yuqk
鵹	tqtow
騀	ctrt
腵	enhc
彃	xjaft
鲸	qgy
鮵	qouqh
䃳	dvln
鼢	vnuvn
䬺	wyvdp
櫣	salp
嚥	kauo
蕸	anhp
䱣	qoyf
䵔	twii
黋	iqaw
䱇	qojg
嬽	vlhd
䛫	ydey
騉	cjxx
䚧	qene
繰	xkks
緼	xjlg
蹍	khnea
颿	cmtj
藴	axjl
豒	dhdt
檷	sgwqa
項	admy
颐	ahkmq
䜞	yyjg
恍	niq
酄	akkbt
鏟	qutg
䪘	nhkhe
㶑	iwgw
躯	tmdqg
絥	xwdy
驨	cmwk
䴋	wvgeb
䠀	khik
䈧	teto
紜	xfcyk
鸚	mmvo
虀	aydg
蠬	juedw
樤	swhs
暟	jmgu
垂	tga
栫	sdhb
鏽	qvfj
媔	vdmd
鴌	gdwo
灒	itfm
頊	gdmy
䮘	cvqn
薼	aynf
鳆	qgtt
譫	yqdy
鲬	qgce
輪	lwgai
㟃	mngk
爗	ojaf
瓽	ipkn
橃	swxc
鏨	lrqf
曪	jlxy
㲂	imkc
荳	agku
㝺	uvot
駅	cnyy
㵍	iuny
赵	fhq
鮉	qovke
扟	rnfh
橕	sipt
赘	gqtmx
矖	hgmx
鼘	fkugy
騈	ctff
㠩	wnqb
䭈	wyvpf
弒	qsya
鲣	qgjfu
䖇	asre
輮	lcbs
﨏	fwwks
駻	cjfh
僬	wwyo
濎	ihnn
麺	gtdd
鯋	qoit
綦	adwi
酈	gmyb
縛	xgef
䟋	fhqy
嫝	vyvi
䘲	puvci
卻	wwkbs
暈	jplj
㑙	wbnn
隆	btg
䍤	lyjf
荈	aqaha
簾	tyuo
轈	lvjsm
啣	krhb
棖	sdey
魶	qomw
骄	ctdj
湛	iad
顆	jsdm
循	trfh
䭎	wyvs
㝹	itqy
鴈	dwwo
䫦	fclm
䶂	vnuy
恟	nqqb
婽	vnhc
欦	wynwr
㺥	qtqyx
煅	owd
骳	mehc
禼	hlqc
鸩	pqq
塱	yvcf
將	nhdfx
騤	cwgdu
穠	tmae
䮏	cgkg
絩	xiqn
䅹	tlvg
鳄	qgkn
謁	yjqn
䝔	eakys
漿	nhdi
䰝	gkmj
羲	ugt
䨯	fbgi
篪	trhm
緁	xgvh
䊠	vcaou
駫	ciqnl
曻	jqah
鶝	gklo
喩	kwgb
䡞	hwlj
觵	qeaw
駌	qbcu
娠	vdf
鴧	pmwo
喂	klgi
㩠	rynoy
縄	xjjn
鹽	ahnl
錏	qgfg
櫉	sdff
繐	xgjn
䳑	dewo
矉	hpgm
鲮	qgft
勸	akkl
鴯	dmjo
漵	iwtt
㨪	rjiq
鵧	uawo
䋋	xnan
㭛	srey
㴐	ihgn
絹	xkeg
薎	alpa
资	uqwm
䱁	qosgp
郪	gvhb
鴤	wvgu
頔	mdmy
䇬	triu
纈	xfkmu
涎	ithp
閕	uahtm
㪩	vfjc
䭊	wyvdz
㒇	wrlo
鹙	toqg
摖	rwfi
选	tfqp
䑴	teawm
㻈	grgk
㫇	ywun
揯	rnggu
䋪	xbsk
餟	wpcc
䲙	qotb
姝	vri
戲	haga
嘝	kqef
膺	ywwe
蛍	ipju
䲜	qoqo
㾳	uuqv
軌	lvn
之	pp
鶻	mewo
㰡	wjqw
骗	cyna
珔	gdhb
䡰	fnml
滌	iwhs
癶	wnyt
吹	kqw
㟜	mxqi
瀌	iyno
隑	bmgu
㢑	ywyfw
㕳	kqbh
觧	qeud
䇧	tglw
鲑	qgff
滭	ijaf
倱	wjxx
俹	wgfg
乕	rfmh
問	ukdx
餵	wple
㲈	fnmkk
倾	wxd
㲖	ietn
額	ptkmz
猟	qtih
訁	yygg
桸	sqdh
啸	kvi
濃	imae
䱓	qotp
憪	nueg
䚢	qeas
㩶	rtgq
姒	vny
捗	rhit
滪	icbmh
䯜	mejr
僆	wlpy
鸛	akkon
鱄	qogf
坒	xxff
陟	bhi
橌	sueg
亐	fnvf
鄶	wglb
潇	iavj
糺	xnnr
膷	extb
菄	agji
欅	svgr
巃	mued
鼃	ffmv
酷	sgtk
䡟	lrtfk
䰔	detl
㸐	akfo
軅	tmdyf
諧	yxxrr
䂹	dqoy
㬄	jdfou
梟	wvgsk
轣	ldthu
飙	dddq
麵	swwdh
逓	rfmp
唌	kthp
㿑	unwy
懏	nwym
㙾	fvqb
継	xonn
漩	iyth
䊥	ovfja
攧	rfhm
续	xfn
峦	yom
縆	xnggn
軑	ldyg
鳹	wynoc
䜑	ygfn
艁	tetk
㺁	qtvq
媇	vusyf
㒧	wyby
䡭	ludft
宵	pi
靱	afvy
鋊	qwwk
龮	龮
䲫	gqwoy
䋒	xcbt
橞	sgjn
疎	nhgi
㭿	sjqb
㟪	mlgee
㙫	fwys
鮝	udqom
毃	ymkcd
鼙	fkuf
黌	vqqw
麂	ynjm
酰	sgtq
峼	mtfk
觨	qeai
巪	annb
隞	bgqt
滣	idfk
鷞	dqqo
盨	edml
骘	bhic
貿	qyvm
鲰	qgbc
兪	wgebi
飵	wptfm
䱟	qond
䂻	ddey
戽	ynuq
繓	xjbc
淨	ievh
㮱	satq
廌	ynjoy
嬒	vwgj
㧥	rtfq
澛	iqgj
展	nae
鴝	qkwo
僛	wadwx
㯑	sxde
慭	godn
鼚	fkue
鰈	qoas
鵷	pqbo
粊	xxou
㽫	yxtl
䦫	uamd
壛	fuqv
詧	wyfb
钦	qqw
殶	ygmc
鷩	umios
㩛	rlgf
糿	xvn
鲆	qgg
㜪	usrv
擭	rawc
䃩	dmae
嘠	kdea
虋	avmv
駭	cynw
惾	nqbt
篿	tgjf
驊	cagf
䱭	qong
䱅	qogs
攒	rtfmx
擷	rfkmd
㰲	akgw
焛	uoi
嚏	kfphp
檐	sqdy
橛	sdu
䴎	lllov
酦	sgny
禕	pynh
輡	lqvg
愨	fpgnn
䴖	geqg
縫	xtdps
鸺	wsq
鬥	hgghr
瞝	hybc
沔	igh
兴	iw
㰤	skqw
祭	wfi
鰉	qorgu
鱭	qoyfq
硳	dfoy
鰔	qodt
飛	nuth
鄻	fwfb
咝	kxxg
魧	qoym
雎	egw
鮏	qotg
㼾	ynjn
鑥	qqoj
鵭	qwvo
嚳	vqqk
鰕	qonc
鵱	fwfow
輚	laat
鄰	oqabs
紟	xwyn
欸	ctdw
瓗	gmwk
䶪	hbfy
餦	wpde
䬧	wyvqy
㘈	kxth
潧	iulj
椏	sgfg
篤	tcu
萋	agv
伺	wng
偦	wnhe
䐚	evcb
纲	xm
鸼	teqg
锆	qtfkw
韟	nhkf
㰥	anqw
䒌	pjuc
揋	rlge
㔅	vfjj
㗹	kwynb
甑	uljng
弥	xqi
瀰	ixgq
㶃	iiro
淮	iwyz
禧	pyfk
㢘	yuvoa
餿	wpvc
㚇	qbwt
騷	ccyj
觀	akkq
頍	fcdm
臶	gcfbe
箾	tiej
摝	rynx
㛟	vqmd
鼗	iqf
蒰	atec
烃	oc
鳓	qgal
剅	gkuja
爑	oawo
鵈	bwvoc
蕱	atie
厨	dgkf
靗	geiq
嫓	vqmx
媅	vadn
鄷	magb
誉	iwyff
緞	xwdc
碯	dvtq
緄	xjxx
気	rnqu
䮃	cfcy
鲴	qgld
紓	xcbh
䋼	xecl
剎	qsyj
旝	ytwj
絻	xqkq
懻	nuxw
繮	xglgg
潐	iwyo
嶊	mrwy
䜱	wwkcq
䪻	cadm
汳	ircy
紏	xufh
噌	kul
騽	cnrg
賬	mdey
壾	fkung
餬	wpdet
容	pww
䉟	trwc
蠅	jxg
䔍	acu
徿	tued
閥	uwae
鶄	gewo
綒	xebg
雓	wtwy
㯄	ssrc
壅	yxtf
轡	xlxk
㵎	iuegw
鸮	kgng
兟	tfqq
儻	wipo
鲷	qgm
龘	uegdf
䩄	dmjqw
㵪	iugw
輟	lcccv
鷌	wvgcr
棣	svi
顟	nwem
徫	tnhhb
镌	qwyei
霴	ffci
蹏	khrmp
頌	wcdm
趑	fhuw
筅	ttfq
䮪	cqas
䗽	xwyj
霮	fian
㒋	wadr
衘	trhh
壦	faky
骣	cnb
鮦	qomk
譍	ywwy
险	bwg
塏	fmgu
娰	vwnw
欏	slxy
啿	kadnh
豂	wwke
返	rcp
蝢	jdmye
㨻	lrrj
䚣	qejh
喡	knhh
曭	jipo
賺	muvo
举	iwf
鼓	fkucw
饂	wpjl
銫	qqcnl
嵞	wtmm
魹	qotni
駜	cntt
雝	vkcy
賟	mmaw
穐	tqjn
镥	qqg
䉜	ttdyc
䇓	edmu
䊾	xsy
艐	teqtx
鶭	xywo
崁	mfqw
顦	wyom
䭂	wyvcj
㻌	gwty
櫩	suqv
鄳	xbh
憓	ngjn
䉊	tcdl
睁	hqv
揟	rnhe
嘕	kgho
枢	saq
䢈	dfejm
鴥	wvgwr
䦰	uqjn
傑	wqas
犸	qtcg
壞	fyle
囄	kyby
与	gn
渾	iplh
緣	xxey
癤	utvb
鵠	tfko
䜿	ahnuu
䊺	xgxg
驣	cudc
郄	qdc
撐	ript
褥	pudf
榷	spwy
鰏	qogl
㬱	tfqjs
瑙	gvt
癠	uyjd
䭭	uthm
綬	xepc
鸋	pnlo
斤	rtt
鞘	afie
毖	xxnt
骱	mew
甕	yxtn
㺌	qtuo
磳	dulj
镾	dgwq
餔	wpgy
㰧	ckqw
䫭	khgmq
薦	aynoz
鵦	wvgi
紹	xvkg
䦵	ugwq
䆮	pwic
繈	xxcj
䦐	urk
鮭	qoff
樄	sbgi
蠷	jhhyo
曷	jqwn
殔	gqvi
鼧	vnux
闢	unku
璑	grlo
鼞	fkufk
竫	uqvha
鴄	aqwot
鑺	qhhy
濋	issh
鲖	qgmk
衞	tnhho
麟	ynjh
尔	qiu
鼁	fcmv
䲡	qgug
劉	qyvj
龒	uegi
存	dhb
誾	uydz
饆	wpjf
疫	umc
爉	ovln
墏	nhdfa
麐	ynjkc
䢰	nwyp
䵸	toxf
虄	ajtg
攤	raky
緿	xckn
轗	ldgn
諌	ygji
蟾	jqd
鷨	agao
䱹	qoua
赮	fonc
㰙	saky
籪	txxrp
絏	xjnt
鼺	vnulx
解	qev
亊	guvh
䈺	txtu
俽	wrqw
㨶	rwvo
瀏	iqyj
焁	kqwo
䯅	cbcc
蟡	jeto
載	falk
紲	xann
紝	xtfg
䎋	tfkn
鱖	qodw
翷	oqanl
䳢	adwo
篏	tafw
㩷	rpfc
鱫	qoet
鼡	imfh
㯆	sutg
堪	fad
誅	yriy
虌	aumv
艷	dhdc
疖	ubkv
魲	qoynv
褄	pugv
癣	uqgq
岗	mmq
婾	vwgb
䌃	xiej
餗	wpgi
鄫	uljb
窿	pwb
䱯	cbtox
䗔	jwndd
飩	wpgn
嗁	krhm
㑔	wdmy
獃	mgkd
抠	raq
憺	nqdy
嚨	kued
欿	qvqw
歙	wgkww
鶡	jqwo
耬	dikv
稳	tqv
芟	amc
挽	rqkq
䧵	pqwy
嶈	mnhf
鏺	qwxc
㿥	rpwyh
蔬	anh
壴	fkufs
驼	cp
偸	wwgb
典	maw
寲	pxth
㔁	wgkjt
籸	onfh
㞳	mufh
鰃	qolej
攫	rhh
魭	qofqe
繅	xvjs
䓈	atmc
褘	punh
駊	chcy
梌	swty
鰡	qoql
閅	uskq
免	qkq
螕	jtlx
氅	imkn
慇	rvnn
摛	rybc
鵑	kewo
嚕	kqoj
螂	jyv
嬭	vgwq
竷	ujtt
敶	bgjt
鮘	qowa
蓦	ajdc
骋	cmg
糂	oadn
琤	gqvh
闠	ukhm
慊	nuv
甒	rlgn
癱	uaky
鑜	qipm
膨	efk
㺛	qtca
鷖	atdo
骲	meqn
㱊	depwi
劔	wgky
樃	syve
䲘	qotnu
星	jtg
綽	xhjh
䠩	khht
巛	vnnn
遤	cpi
刍	qvfz
㧡	rynw
膾	ewgj
懿	fpgno
俨	wgo
綖	xthp
鎒	qdff
砍	dqw
麋	ynjo
塯	fqylm
䩎	dmjw
嬩	vvgw
烏	wngo
鷍	thso
峃	ipmj
絘	xuqw
瑯	gyvb
谾	wwka
䶣	hbmu
頑	fqdm
㜷	xgwv
彲	gmyeq
䯦	meat
䣕	cbh
㭥	sqmy
㬝	julj
縲	xlxil
侷	wnnk
攡	ryby
祋	pymc
顊	wnnmi
䌬	xued
㜧	vduw
燫	oyuo
奬	nhddd
饁	wpfl
䙰	puyyi
絃	xyxyk
鯔	qovl
獁	qtcy
荬	anud
褀	puaw
䵽	fkuc
鮸	qoqq
錐	qwyg
赦	fot
㬗	jqdo
驋	cwxc
銗	qrgk
擱	rutk
舋	vmgg
姯	viqn
寏	pqmd
嶉	mkwy
鷾	ujno
囅	kkjee
橷	surq
㱶	gqfe
颜	utemc
㡡	mhdf
鷵	nfto
䜽	gkujm
鰸	qoake
氦	rnyw
嘫	kqdo
奂	qmd
魞	qoty
蜖	jmjd
㣳	trloz
瞱	hagfi
炙	qo
㶛	iytw
咣	kiq
䞔	fonn
簘	tvoj
觭	qedk
錽	qgot
餘	wpwt
綛	xvyn
鸟	qyng
閰	uvd
鸳	qbq
鵌	wvgts
罾	lul
湰	itggo
轕	lajn
軐	lnfh
褲	puyl
䊹	xtfhj
藰	aqyj
鲶	qgwn
䣄	wtbh
赅	myn
料	ou
㮧	swno
码	dcg
鲁	qgj
鯤	qojx
絟	xwgg
鶃	wvgq
塼	fgjf
䮮	cswq
槯	smwy
㯛	sfpg
藓	aqgd
峞	mqdb
邶	uxb
洸	iiqn
魐	rqco
䕑	axev
䞧	fhrk
坄	fmcy
㱆	hagw
䶵	wgkmp
栉	sab
䇐	uviy
舛	qah
诜	ytfq
嘯	kvfj
鄧	wgkbp
軁	tmdvh
癰	uvky
䕙	afay
餕	wpct
㬋	jwnd
蘾	afye
䊁	otfq
羁	laf
籂	twph
䃠	dyth
戦	ijfa
䪠	tnhgc
鸸	dmjg
鲔	qgde
䶞	hbaw
餞	wpaa
纄	xatp
龉	hwbkt
繷	xmae
䮎	cqdh
藿	afwyv
亃	oqanm
躢	khun
帇	vmhk
觮	qevi
酴	sgwt
郎	yvcb
蔼	ayj
躣	khhyj
孠	ngkb
䕘	awym
骛	cbtcw
鍇	qxxr
勂	tfkl
嶡	mduwz
蕝	axqc
攜	rmwk
鮩	qouad
焳	owygx
颀	rdm
䪱	ndmy
麓	ssyx
瞯	hueg
䭧	wyvic
鵃	tewo
鸿	iaqg
㦂	ipknh
乀	yylly
脪	eqdh
璈	ggqt
鶳	wvgh
㮅	swyfm
竄	pwvn
蔡	awf
惠	gjhd
䑓	afpf
蛋	nhj
䮫	clvg
硞	dtfk
骍	cuh
䡎	lynt
謱	ykgvo
䌩	xalt
鑿	oguq
礶	daky
掑	radw
藃	aymw
噙	kwycw
㽰	eenh
䭉	wyveh
䫖	adwm
䋦	xtxu
顃	oodm
皣	ragf
騙	cynap
觺	xtde
蹛	khahf
鰽	qogj
胏	etnt
傉	wdff
綆	xgjq
鵙	mwvo
邂	qevp
縇	xpggd
窲	pwof
喲	kxqy
鶸	xuxo
䯏	metd
䯠	mejl
鸫	aiq
䞅	mdfk
嘻	kfk
䠈	khvit
爫	etyt
緲	xhit
蕯	abtg
糈	onh
緃	xwwh
捵	rmaw
韥	nhkm
䴨	ynjiq
䦑	unwi
鲞	udqg
輛	lgmy
楡	swgb
魓	rqcfu
敳	mgkt
闅	uhhc
亲	us
硃	driy
䳯	tgjo
㖽	kdmyn
鉯	qnyw
琠	gmaw
䫒	qajm
訤	yqqy
䲄	qottm
䡩	lfhw
儅	wipl
磂	dqyl
歛	wgkwn
繊	xfag
搉	rpwy
闐	ufhw
瀟	iavh
鹯	ylkg
㱇	fwww
䩂	dmjnx
骙	cwgd
䳊	dcwo
䋖	xvfh
鼊	nkuvl
䯴	demc
鷋	awto
籊	tnwy
㾝	ulk
鮑	qoqn
敻	qmwt
䥢	fkuq
䭃	wyvn
崠	mgjit
矦	qdtd
嶔	mqqw
䴊	ugto
㬦	jawcy
濲	ifpc
颵	mtje
綪	xgeg
䫝	tjdm
嚿	kawv
馰	cqyy
䥫	qfay
礊	lbmd
玺	qig
絾	xdnt
鎫	qtmtt
㩂	rqef
䠍	khnc
逗	gkup
鲤	qgjfo
鷐	jdfo
陳	bam
珠	gr
蟵	jdgf
頖	uddm
㣸	toeg
䦏	uwjk
餶	wpme
䃑	dtec
假	wnh
鶜	acbo
薺	ayjfl
觾	qeao
寵	puedi
赫	fof
钭	quf
㸸	trrk
葦	anhh
㤀	tynn
鳾	gmho
䦱	ueto
催	wmw
蕦	aedm
覚	iphq
殾	ftjcq
瀙	iusq
鰚	qopg
繥	xfkk
麒	ynjw
獕	qtmy
鍌	itfq
䧍	bwwk
煩	odmy
䱌	qoahm
㐞	adwnr
鬙	deuj
贋	dwwmq
檇	swyno
溈	iyto
旟	ytvw
灝	ijymc
籲	twgm
䲻	yxwo
儈	wwgji
鲂	qgyn
䱆	qoebt
騱	cexd
駦	udcu
鸙	wgkor
䰵	qobg
豓	dhdls
鞸	afjf
贈	mulj
㩭	rvqb
捇	rfoy
嶷	mx
攦	rgmx
嫛	atdv
漈	iwfi
准	uwyv
侟	wdhb
忷	nqbh
镢	qduwb
鰝	qoyk
鵒	wwko
硵	dhlq
儂	wmae
䡉	lymnv
闯	ucd
鐙	qwguj
霻	fmau
䭄	wyvh
颉	fkd
䳠	tgao
蘸	asgo
瘎	uadn
䌈	xjng
㰞	mqwy
絇	xqkg
冤	pqk
㗵	koow
䌅	xyvk
碿	dnie
筚	txxf
鴙	tdwos
稯	tqbtb
䫧	rdfm
皫	ryno
矟	cbtel
蟢	jfkk
䳟	jewo
膗	emwy
矊	hxrh
騼	cynx
綜	xpfi
譙	ywyod
擔	rqdy
鲯	qgaw
鲿	qgic
鮂	qolw
㥁	flnn
䋵	xjqn
燴	owgjz
蔇	avcq
疈	gkllx
䡂	lnhh
欵	xtdw
䁪	hlrh
鸐	nwyop
憎	nul
謋	yqas
瓘	gaky
䳡	wywol
䈓	tjqn
驶	ckq
䭔	wyvpe
螌	temj
摤	rdqq
䚤	qejc
饝	wpyd
䲚	qogm
鰎	qovp
孄	vugi
駃	cnwy
瞦	hfkk
塶	fynx
坂	frc
鶑	oowo
嗽	kgkw
嵿	msdm
寠	pkgv
鈚	qxxn
傿	wgho
襱	puudk
鸈	oguou
稭	txxr
嶅	gqtme
簡	tujfp
焮	orqw
兠	urxq
竵	ugkh
䪣	gmhgl
饟	wpye
綂	xyqn
茎	aca
殊	gqr
䡫	ltdp
䏱	ennk
鐎	qwyo
須	ed
骎	cvpc
欶	gkiw
鎦	qqylr
漲	ixde
骅	cwx
䐡	ymww
㑺	wwye
㬟	qruj
紱	xdcy
慙	lrnu
遞	rhap
濒	ihim
縔	xccs
雥	wywyf
㼱	uxpn
㔒	mwyj
鮮	qoud
軋	lnn
䌞	xwgw
㿍	uqeh
鴅	mywo
葚	aadne
㐣	ylnv
以	c
棠	ipks
须	edm
圙	lwdd
豰	fpgc
爊	oyno
轑	ldui
䫅	psdm
㾿	uyvb
䢭	ugup
迹	yop
罄	fnmm
䧥	bgjn
鰞	qowox
䶓	mhyj
鷹	ywwo
鵮	qvwo
䳛	jvwo
蘅	atqh
瞠	hip
㨱	rqyg
歃	tfvw
䚩	qetky
觴	qmfr
鼉	kklv
孋	vgmx
䡐	lpxn
顖	tlqmq
蹭	khuj
籱	tfwyy
榝	sqsc
軾	laag
䦕	uuak
㱅	fpgw
哨	kie
劗	tfqj
了	b
誠	ydntw
鮷	qoutz
䌓	txgil
檜	swgj
㢢	imka
礲	dued
堂	ipkf
䊽	xnwy
貔	eetx
硁	dcag
軦	lkqn
䦧	uvqv
饃	wpad
驧	cafo
墲	frlo
业	og
鯁	qogq
鼝	ijgc
鄉	xtyb
痉	uca
屨	ntkv
鞨	afjn
斟	adwf
䪍	afui
絖	xiqnb
餸	wpup
縰	xthh
頽	tmdm
嚐	kipj
软	lqw
瘵	uwf
韂	afqyb
鳼	ywvo
㾲	ugqt
䳋	jwvo
旌	yttg
鲵	qgvq
鍛	qwdc
䇜	tqwu
㴥	imie
枇	sxxn
騏	cadwo
㪸	adwfj
峪	mwwk
橧	sulj
榐	snae
䌝	xssi
鬩	hggq
㩦	rwyk
䯂	cccsn
熲	xodms
鴣	dwvot
霢	fere
䳰	wksok
礗	dpgm
飝	nuthh
葠	awvc
螔	jrhm
潁	xidm
隮	byjg
頻	hidm
梪	sgku
㮢	swnd
顺	kd
飲	wpqw
艩	teyf
鳤	qgtn
嵚	mqqwb
䦄	qgje
䵹	tdkx
塎	fpwk
龱	龱
瞤	hugg
鹿	ynj
隽	wyeb
鳽	gawo
嶩	mmae
䱈	qofi
䁓	hqbt
箹	txqy
䦣	uukdv
䱜	qoaj
駣	ciqn
触	qejy
曦	jug
緭	xleg
彀	fpgcg
謢	ywyct
镟	qyth
马	cn
鮗	qotur
䲇	qogp
㬬	jhhy
闛	uipf
鸕	halo
鑇	qyjg
亜	gkjg
麡	ynjfn
溊	inhc
梴	sthp
籆	tawcf
㯶	sobt
瘤	uqyl
僡	wgjn
犐	trtfn
难	cw
鹺	hloa
亄	fpgn
䣀	qdbb
䜬	wwkm
蒥	aqyl
噥	kmae
饇	wpak
絆	xufhv
敞	imkt
噺	kusr
㝩	pyvi
輥	ljxx
䌮	xfsh
䮤	cpwy
闈	unhh
䬿	wyvnf
颠	fhwm
胲	eynwp
㪵	uduf
鹎	rtfg
胸	eq
铼	qgoy
撚	rqdo
糓	fpgcb
魦	qoitc
䧶	wyuu
甊	kgknh
鵩	ebco
㛱	vlges
徃	ttgg
蟨	dubjt
鴞	kgno
哶	kgjf
㻲	glvg
襴	puui
鰿	qogma
鷡	rlgof
鍕	qplh
棟	sgjij
恖	tlqnn
攞	rlxy
廇	yqyl
縴	xyxhl
颁	wvd
覐	hqqq
煇	oplh
濉	ihw
譄	yulj
縥	xdwt
頇	fdmyl
媈	vplh
鲒	qgfk
印	qgb
䴈	tmoo
䍵	udqh
㐅	qtyb
鹍	jxxg
緎	xakg
應	ywwnp
派	ire
䪊	afud
胥	nhe
䖄	aako
绲	xjx
酂	tfqbn
暉	jplhj
駩	cwgg
鮎	qohk
鼮	vnup
菎	ajxx
䂀	hugt
醨	sgyc
鳔	qgs
䦋	dgqt
憂	dept
攛	rpwn
䨭	ffce
䩥	aftpg
籗	tfwy
陔	bynwy
緋	xdjdy
籏	tytw
貛	eeaya
鷴	uswo
蔙	ayth
窚	pwdt
㖁	kqdc
䈩	twgjh
颢	jyimd
颂	wcd
騣	cqbt
䋡	xwty
懼	nhhy
躪	khayn
鯒	qocej
鷬	amwo
塗	iwtf
觷	vqqe
顏	ydem
磢	ddqqq
㾩	utfx
亞	gfgd
鰘	qopf
䔑	awtf
凗	umwy
籠	tuedx
郜	tfkb
驓	culj
㶄	iuqv
農	made
氬	rnggr
棍	sjx
䫶	sqqm
慾	wwknw
鸎	mmwo
畄	ilf
闥	ufup
闡	ukkf
澍	ifkf
潓	igjn
蓇	amef
讻	yqbh
䴃	fffo
缛	xdfft
嫙	vyth
蔹	awgth
詬	yrgk
饚	wpal
嵊	mtu
濰	ixwy
銷	qieg
嶨	vqqm
磠	dhlo
茬	adhf
璢	ggal
䡑	lnan
㾛	uvpct
㽕	mnnb
曅	jagfo
䦖	ufkd
鴏	wvgan
㧏	rmqy
䜮	wwkh
麅	ynjna
僩	wueg
薪	aus
䅶	tdff
辱	dfef
噷	kujw
䳒	fawo
爤	oauip
斖	yvmgt
閩	uji
顎	kkfm
㒕	wyxy
䔵	ausu
磴	dwgu
漹	igho
鲹	qgcec
绦	xts
㥧	ndmyz
縒	xuda
駞	ctbn
㤧	nrgk
緒	xftj
巄	muedk
織	xuaj
兂	aqv
玭	gxxn
㺧	qtkk
綯	xqrma
纉	xfwm
蔠	axtu
淸	igmg
㿩	ripor
穎	xtdm
俁	wknd
羄	lxhj
蕨	aduh
畢	jafk
軯	lguh
䫫	lvdm
僧	wul
學	vqqb
鶏	efwo
薅	avdf
篗	twycu
冈	mqiw
龁	hwbnt
槲	sqef
蘊	axll
䉐	tldfk
㽄	adwnb
椚	sugv
鷪	hhpo
䌁	xsvg
蒢	abwt
验	cwg
灔	imac
龂	hwbr
濝	iadi
壐	gwmf
㦵	riat
㶋	ioeg
廝	yadr
䱢	qoqhh
進	wypd
鎲	qipql
纚	xgmx
綑	xlsy
䌇	xfpi
郈	rgkb
魝	qojh
茝	aahhe
堲	vcbf
詭	yqdbg
戁	akfn
㽮	lllgl
㙲	fyxy
縿	xcce
㰢	gaqw
㔼	rwyf
磬	fnmd
騝	cvfp
楚	ssn
長	deu
䦦	uqdr
黿	fqmv
轂	fpgcn
螞	jcy
䪶	egdm
幋	temh
蜞	jad
䗻	jtvb
櫒	sawi
驰	cbn
戃	nipo
䨢	fadn
躘	khud
氌	tfnjh
檓	svac
餒	wpev
䊦	ofpu
閄	uwy
縉	xgojc
鳛	qgnr
梐	sxxf
䏊	buedq
㚀	fhaa
鶹	qyvo
諍	yqvh
鰭	qofj
鱢	qoks
㴮	inie
涉	ihi
溵	irvc
斢	amwf
杸	smcy
隝	bwvo
㚟	qkxd
镕	qpwk
辚	loq
䮽	cyno
靦	dmjq
讐	wywyp
䫘	jqwm
熹	fkuo
㦫	ntfm
䭵	cmyy
䝍	eplh
峐	mynwp
舨	terc
髀	merf
䳵	swwoj
癎	uujdk
斴	oqar
觢	dhve
綕	xfny
嵕	mqbtd
䡋	lfcyt
頪	odmyr
禥	pyaf
琵	ggx
碪	dadn
馄	qnjx
竳	uwgu
輘	lfwt
䡵	luep
鮹	qoie
㷻	orlo
塦	blff
網	xmun
振	rdfu
髐	mefq
愯	nwyck
㓩	qejha
骐	cadw
髂	mep
鶯	oopov
蠀	juqm
鼴	vnuvd
驺	cqv
儭	wusq
膿	emae
鄦	rlgb
丣	gajn
爭	evhj
褱	ylie
隻	wycu
隬	bgwq
䧠	bgjf
鏀	qhlok
綥	xlgj
鶍	jqro
痪	uqm
癚	uqdyk
诛	yri
顅	ynem
巏	maky
欟	sakq
镸	dghy
䰏	defy
䤭	qqdh
㜳	vyle
㽹	urci
孈	vmwk
嗺	kmwy
縡	xpuh
親	ushq
鹜	cbtg
鱛	qoujk
侊	wiqn
紷	xwyc
䲶	fqwoo
繦	xxkj
䫉	eedm
嵏	mqbt
廥	ywgjd
绤	xwwk
驁	gqtc
䢉	vtle
璳	grim
甎	gjhn
飯	wprc
䉧	tqyj
㑾	wqyg
震	fdf
䘁	fawj
鼬	vnumz
㽈	xtdn
龝	ttmg
饑	wpxt
读	yfn
䨂	towy
垝	fqdb
䬽	wyvqn
際	bwfi
緾	xdjf
㚨	vnfh
櫆	srqf
趂	fhqi
愐	ndmdr
噦	khdt
䰉	detc
㭤	sqyg
䉍	tunu
赎	mfn
䒉	terhh
鰅	qojy
鮴	qows
䮜	cans
鈄	qufht
锔	qnnk
綼	xrtf
掌	ipkr
頼	gkims
蠸	jakyu
韎	nhkso
蘭	augi
島	wvgmn
駆	caqy
舞	rlg
鸦	ahtg
雌	hxw
潋	iwgtf
水	ii
嚩	kxgf
焗	onnk
頋	dbdm
䮡	ctjt
闒	ujnd
㙉	fmaw
魺	qosk
䣴	sgqq
閠	ugyia
鴚	wvgk
紡	xyn
㑮	wplh
䔲	awgu
慨	nvc
閡	uynwb
縜	xkmy
䁢	hyth
脣	dfee
髃	mejy
蕽	amae
䪡	tnhgn
馋	qnqu
泶	ipi
䘠	pudq
㪓	tfuc
夦	adwq
葒	axaf
鱂	qonf
韊	afai
璡	gwyp
孉	vaky
浱	idfe
蘱	aodm
锥	qwyt
辴	kkje
踑	khaw
䱲	qoxe
飪	wptf
盗	uqwl
鷗	akko
駮	cuqy
顪	hdgm
摙	rlpy
㳬	itnh
鰒	qott
甤	etgd
軻	lskg
䶒	yjfv
颗	jsd
韞	nhklu
蜒	jthp
㐽	wmqyn
戄	nhhc
鏘	qnhf
馲	ctan
䀝	hxxn
棦	sqvh
鄡	wvgb
䶲	mftx
縋	xwnpr
䯓	meff
䮋	cgqj
礎	dssh
弞	xqwy
甔	qdwn
晃	ji
攔	rugi
屑	nied
䵱	lfoky
㸋	qotll
舃	vgno
灍	iuuw
谹	wwkc
胱	eiq
严	god
鮯	qowk
皱	qvhcg
蘈	atmm
䟻	khwt
鶓	alwo
䦪	ujqnh
䚹	yxxn
駝	cpxn
鵍	pfqo
鷕	kwyor
郩	qdeb
芡	aqw
儁	wwym
㠱	nadwp
懽	naky
䱙	qohc
讕	yugi
懷	nyle
䴔	uqqg
盥	qgi
㓎	uvpc
魌	rqcw
僼	wmau
爀	ofoo
攩	ripo
䲨	awvoa
䱗	hqco
㿗	utmm
㲆	fnmcd
祰	pytk
䮑	cefy
䶈	vnuf
莭	avcb
䫪	dqqm
纞	xxyn
款	ffi
歄	mnmw
爟	oaky
墈	fadl
喈	kxxr
鸥	aqqg
纐	xuqm
䦓	uhkdi
䜳	gkun
廏	yrxc
槇	sxhw
惎	adwnt
㻩	guvo
唃	kqeh
㥑	depn
䫋	tvdm
䧳	hwyg
龅	hwbn
鯊	iito
靇	fued
鹐	qvqg
䱄	qory
缵	xtfm
鮥	qotkt
鴔	tpwo
帷	mhw
㔡	tlql
潚	ivfj
嘩	kagf
陮	bwyg
敛	wgit
谼	wwkw
㦦	nuvq
㝲	pnhh
廠	yimt
㮝	swwb
絔	xdjg
犧	trutu
唚	kvpc
䋎	xjgg
駢	cuah
鵁	uqwon
箏	tevh
寭	pgjn
㰯	gkuw
箫	tvij
儶	wmwk
經	xgvag
繞	xffq
擨	rrhw
憮	nrlo
驥	cuxw
龨	龨
麔	ynjks
㸑	vmgo
䌯	xaky
堒	fjxx
㢿	xwndd
颒	iadmt
鳃	qgl
榍	sni
欃	sqkyk
緙	xafh
檨	sugw
鸏	apfo
巔	mfhm
䛰	yjxx
閹	udjnz
䜶	gkuhc
樚	synx
愲	nmeg
隠	bevn
㱐	fhyi
躍	khny
朇	wglf
㺇	qtade
鴗	uwvo
䢇	pmdf
苅	aqjj
騡	criy
㩪	rxdm
毈	qytc
㴴	iogn
䎥	diwk
网	mqq
渴	ijq
㘖	kutm
嚫	kusq
鵶	gfgo
嫆	vpwk
鵏	geho
軺	lvkg
谒	yjq
獵	qtvni
㛯	vqkl
蔌	agk
殢	gqah
歚	uduw
璀	gmwy
榪	scy
驟	cbci
㔪	qhlo
軒	lfh
轠	llllo
䪽	kgnmu
焉	ghgy
獑	qtlr
灂	ielf
㭟	awsup
藾	agkm
䒂	tenf
勧	rwyl
嬪	vpgm
䭚	wyvf
鷜	kgko
㶊	iahm
鹾	hlqa
諶	yadnm
顝	medm
渙	iqmd
薿	axth
㣆	xgwg
缯	xul
儷	wgmx
櫢	skgt
㮾	yvcs
斘	qufhs
橉	soqh
餾	wpql
颈	cad
蒬	apqy
髙	yjfkc
儗	wxth
䀚	hqbj
頝	uqdm
讇	yuqv
嫶	vwyo
蔫	agho
臲	thsb
絓	xffg
颋	tfpmq
䱫	gkioy
粃	oxxn
鋀	qgku
殁	gqmc
耨	did
鶛	xxro
粢	uqwo
擹	rakw
螸	wwkj
糰	olgf
漼	imwy
嫏	vyvb
矓	hued
軥	lqkga
骬	megfi
緌	xtvg
摡	rvcq
餀	wpaq
䳏	ffwo
鼅	tdkv
䌤	xgwqb
闗	uxxo
蔪	alrj
蛼	jlhp
驑	cgal
駏	cang
䧷	tuwy
疑	xtdh
㘶	qahf
敖	gqtyr
鹠	qyvg
褫	purm
譧	yyuo
株	sri
禷	pyom
輌	lgmm
塿	fkgv
䭓	wyvu
龟	qjn
龄	hwbc
簊	tadf
荹	ahir
䠠	aqphk
睺	hwnd
麜	ynjsl
紛	xwvn
紇	xtnn
羖	udmc
鐺	qipl
撹	ripq
㻫	gjaf
帩	mhie
劑	yjjh
㷀	oonf
鱅	qoyhj
㗮	qkyw
鋯	qtfkt
翳	atdn
緦	xlnye
靎	fqwo
餤	wpoo
媯	vyto
䋁	xymn
韍	nhkcb
湑	inhe
歡	akkw
頲	tfpm
蟖	jadr
售	wyk
龆	hwbk
鄆	plbh
学	ip
噔	kwgu
䇌	uieg
鲙	qgwc
蔞	akgv
鍎	qrfh
駽	ckeg
䒎	adac
檴	sawc
饎	wpfk
㼓	rcyo
䦢	uifc
㡈	mhqqm
鷒	gjho
顡	uedm
炓	oufhz
㼮	gvhn
䰽	qoght
鳲	nwvo
䋻	xfmf
閦	uwww
蘛	aade
筜	tivf
嶺	mwymi
䱋	qoaw
鷆	xhno
瑦	gwno
幥	mhir
䪹	gigm
蝆	jgkf
瀭	ilwj
䙢	puujq
䊛	oqsc
昂	jqb
篦	ttlx
娸	vadw
鴾	crho
㱷	gqws
墔	fmwyv
奐	qmwd
竈	pwfvk
䫗	nhfm
椳	slgex
䎖	uljn
俙	wqdh
鴪	pwwo
㔳	ayvm
㷫	fnmo
叇	fcvp
腲	elge
㲉	fpgcj
墹	fujgw
隣	boqht
頿	ehxm
暿	jfkko
當	ipkl
籅	tvgw
騛	cnuh
鯲	qoyu
鴢	xlwo
雃	gawy
緉	xgmy
舜	epqh
㼇	gmwm
頞	pvdm
䳫	wgdo
馽	ckhj
鳂	qgle
躏	khayy
餺	wpgf
䔏	atfp
觜	hxq
鷲	yido
輵	ljqn
该	yynwr
瑋	gnhht
壼	fpggk
鱺	qogx
䯌	menv
辨	uyt
螴	bgjj
類	oddm
䳾	wgkoz
䌂	xngf
發	wxmc
㴒	iyoa
睱	hnhc
贩	mr
椶	sqbt
榉	siw
䞱	fhwk
珎	gqiy
䲭	qawo
噕	etnk
颴	mtjh
䍎	rmao
鵾	jxxop
万	dnvo
糴	tyoyg
䥝	qynxy
㺦	qtbg
憹	nmae
㡬	xxdt
蘝	awgwq
䱚	qovi
鵕	cwto
㸕	rhyc
䬉	mtjoi
豊	magu
㼕	ipky
薉	ahdt
惃	njxx
麖	ynji
儹	wtfmf
毙	xxgx
饉	wpag
邹	qvb
㜯	vaho
祣	pyte
淆	iqd
莗	alj
䮢	ctfv
麈	ynjgv
諅	adwy
䜡	ydet
寖	pivc
䱧	qoub
鱙	qofqu
骵	mesg
䡴	lujfk
亙	ghng
䇺	tgku
䡅	lkhh
方	yy
媽	vcy
癯	uhh
弬	xahh
喾	ipt
暫	lrjf
囉	klxy
別	kqjh
娫	vthp
僯	woqh
鯮	qopi
䫆	dnnm
鯐	qofh
髕	mepm
烉	qmwo
甍	alpn
驳	cqq
飻	wpwe
䶀	fkuk
蒶	axwv
髾	deie
屁	nxx
韉	afao
鋮	qdnt
瞧	hwy
䠽	tmduw
燛	nhao
奊	ffgy
㹇	trjn
濶	iutd
䚃	hlnq
鯴	qonj
駀	cdnn
㡞	mhlv
䋝	xivg
禙	pyue
后	rg
茨	auqw
碀	dqvh
顩	wgkmq
鯿	qoya
姟	vynw
縵	xjlc
鱤	qodnl
膲	ewyo
舽	tethq
嗏	kaws
㑽	wipf
劐	awyj
鬉	deqt
颧	akk
䔋	axit
赖	gkim
鏧	fnmq
鞺	afif
罉	rmir
貗	eekv
傾	wxdm
魩	qoqr
駘	cckg
餝	wpay
陛	bx
慥	ntfp
拨	rnt
噝	kxxi
毨	tfnqj
鯰	qownt
鏖	ynjq
鋦	qnnks
鶎	pfio
槺	syvi
驮	cdyo
郕	dnnb
猑	qtjxd
骉	cccfz
螹	jlrh
鯆	qogy
軛	ldbn
燞	wyqo
頓	gbnmm
吡	kxx
窽	pwxw
䬟	mtjji
瞗	htvo
鏶	qwys
䴛	hloe
殴	aqm
線	xriy
曾	ul
䋄	xmqyh
關	uxxgx
䯟	meue
馿	cynt
质	rfm
倘	wim
鄟	gjhb
糛	oipf
覻	hagq
梏	stfk
谵	yqdyv
㱭	gqwc
氇	tfnjk
埫	fimk
㙔	fnhh
闘	ugkf
耲	diye
鹰	ywwgl
烦	odm
瞽	fkuh
㕠	uwyct
続	xfpq
䐪	ewye
斅	vqqc
讴	yaq
䋽	xfff
㙊	fdey
朧	eued
衇	tlre
繭	amhj
礑	dipl
蠼	jhhc
鳷	fcwoa
雗	fjwyr
襽	puai
嬎	vqkg
岇	mqbj
䡺	ldhn
枭	qyns
閼	uywu
瀂	iqoj
舆	wfl
壠	fuedx
佭	wtah
蜁	jtnh
溶	ipwk
雜	ywwyf
硕	ddm
鮡	qoiq
捔	rqeh
核	synw
鶰	kmwo
贀	atdm
呌	kufh
趋	fhqv
痲	usfq
侏	wri
謧	yybc
鯂	qosg
䏑	qmww
䀞	hufhx
鴼	wvgkx
膢	ekgv
㘗	khhyu
㕡	hpgcr
偡	wadn
凶	qb
誛	yvpc
紅	xag
厁	wtub
褎	yqgen
專	gjhf
䳻	lrwo
觓	qenh
䴉	lgko
麃	ynjot
噘	kdu
磼	dwys
魫	qopqa
㝫	pbtg
䎷	briy
碼	dcy
屒	ndfe
鶪	hdwo
诡	yqd
靄	fyjn
璵	gvgw
腖	egji
餷	wpsg
譪	yajn
㮤	pwwsd
願	drim
餑	wpfb
閧	uawi
䥳	qdet
䒛	axnb
䜝	yxxnj
煯	oxxr
䑁	wfqe
䨲	fdmyq
㸆	otfd
谗	yqk
頒	wvdm
壋	fipl
馺	ceyy
鹁	fpbg
碫	dwdc
韢	nhkn
頃	xdmyd
絝	xdfn
丂	gnv
䃜	atdd
蒎	air
騩	crqc
顂	swwmu
飑	mqqn
蓢	ayve
癫	ufhm
婏	vqky
殪	gqfu
䕧	ameq
憘	nfkk
鯺	qofjy
鮜	qork
壻	fnhe
蟭	jwyo
襠	puil
䰺	qorh
鱝	qofm
㐷	wcg
狝	qtqi
㫳	dfeji
酆	dhdb
䋿	xlgeb
䆊	tuxw
歌	sksw
崔	mwy
閝	uwyce
駚	cmdy
驦	cfshn
頭	gkum
䵿	fkukj
喉	kwn
䳭	vcbo
傥	wipq
讌	yauo
觟	qeff
哠	ktfk
糽	xsh
鰇	qocs
擸	rvln
韒	nhkeu
芈	gjgh
鷢	dubo
袅	qyne
㶙	iiog
䩇	dmjkl
樉	sdqq
躝	khui
䠄	khmw
㭠	stfq
魥	qoey
橱	sdgf
玃	qthc
䲁	qonfm
㯦	sads
雦	wywys
糾	xnhh
曨	jued
䉨	tuec
䰅	dedm
㪬	nwycl
䤄	sgdd
輈	ltey
䦭	utjd
辰	dfe
飜	tolh
㛸	vfku
䦜	ugkd
弾	xijf
撥	rwxc
蕪	arlo
緩	xefc
暹	jwy
䭸	cwqy
痽	uwydq
鄜	ynjba
歇	jqw
㸅	otvb
褝	puif
癜	una
紶	xfcym
稚	twy
㰌	sfwyb
㴶	ipwyc
噹	kipl
澭	iyxy
轀	llwl
䫲	dgkm
閳	ulkm
鰩	qoem
馾	cpqn
㺟	qtny
裩	pujx
膛	ei
鯏	qotj
笫	ttnt
鄏	dfebg
冯	uc
羀	mqql
㰬	qjqw
鍏	qnhhl
暽	joqh
辗	lna
緖	xftjl
躖	khxg
废	ynty
静	geq
㩣	rnpl
检	sw
㜭	vipl
歓	rwyw
黨	ipko
轅	lfke
发	v
涂	iwt
凒	umguy
欫	rhqw
璂	gadf
礭	dfwy
㪷	gkufs
镫	qwgu
鰠	qocj
㰸	wgkwy
湎	idm
挀	rrey
䤽	qliy
亦	youk
㾯	ulgec
蘹	anye
鼆	pjuv
埭	fvi
犨	wywh
璉	glpy
矐	hfwy
欬	yntw
較	luqy
䯋	medc
㷜	oyod
鵘	vtkok
愹	npwk
鄢	ghgb
紵	xpsh
覊	safc
蔎	aymc
䭶	cgjh
蒳	axmw
䱑	qorr
轔	loqhm
䌫	xahqo
礱	uegd
㾬	uxxr
鬞	deme
䳣	faqo
鳩	vwvor
䂁	hqky
㶅	ivqb
䭥	wyveo
鮈	qoqk
鼷	vnud
繌	xtlt
䲆	qoqoc
純	xgbn
澵	iusr
阧	bufh
㹆	trpl
謃	yjtg
泀	ingk
顁	pghm
厮	dadr
詵	ytfqg
歎	akfw
䕟	avmw
撷	rfkm
筵	tthp
䚂	fohq
瀫	ifpcl
頳	fodm
㰜	sfhm
㱄	lfow
鶊	yvwo
骽	meev
䛇	ymkg
鱃	qoufq
誚	yieg
䋺	xtoy
媍	vqmy
捫	rug
艳	dhq
襛	pumei
跪	khqb
彟	vfac
彇	xvfj
㦧	ntfj
觠	udqe
鑨	qued
庼	yxdmj
鏯	qdqq
歝	lfuw
艠	tewu
䚻	qyf
薙	atdy
㗿	kusk
篠	twhs
䴗	hdqg
鞔	afqq
鷰	aukoc
䐩	emgu
廤	ylkx
鰌	qoug
䟒	fhayn
郂	yntb
鶉	ybwo
䦠	ueyi
縞	xymk
䯑	meiq
抝	rxnn
粼	oqab
魷	qodn
㳈	ifqn
欤	gngw
鹘	meq
鰰	qoph
礬	sqqdk
絲	xxiy
㠡	myce
紀	xnnp
鶩	cbto
櫛	stvb
膍	etlx
驯	ckh
鸶	xxgg
獓	qtgt
樓	skgv
頠	qdbm
薕	ayuo
簖	tonr
脳	eiqb
臋	naww
硨	dlhw
㰎	smwm
繼	xxxnq
㯊	sgho
䦴	ulffp
餽	wprcs
顚	xhnm
䡾	lhad
堩	fngg
䵁	swwfr
䩕	afqbu
嵁	madn
駷	cgki
鳇	qgr
唇	dfek
继	xo
麛	ynjb
骮	meay
綄	xpfq
躦	khtm
氀	kgkn
䧺	dkwy
聸	bqdy
钂	qipo
鮓	qotf
鸽	wgkg
礂	dfkk
魼	qofc
熦	oiwy
镵	qqky
鱰	qolj
灎	imal
漙	igjf
閍	uyv
杩	scg
鳫	dwvoe
鎜	temq
饾	qngu
䵴	lfox
蟿	lbmj
鹴	fshg
徏	thit
䳺	wynoe
㙿	fugt
尲	dnuo
顑	dgkml
闑	uths
諱	ynhh
贘	mipm
蘴	adhu
䥲	qakw
䡔	lqqy
康	yvi
懠	nyjg
鼀	fwmv
溰	imgu
灚	ivqq
鬛	delnn
崸	mdmyq
綝	xssy
䉰	tmeq
䁸	hmae
骯	meym
侅	wynw
姿	uqwv
觱	dgke
䝂	ahnud
閊	umk
奁	daq
㰰	dwww
䍠	lybc
欻	ooqw
䙠	pudws
婭	vgfg
驇	fwfcj
毄	lkmc
䚬	qeoh
閫	ulsi
㵲	irlh
飿	wpbm
鼎	hnd
鯥	qoffu
䑏	eaky
鯡	qoddr
笖	tnyw
钣	qrc
穏	tevn
摲	rlrh
旗	yta
鳿	gwvo
鑞	qvlns
蓧	awhs
寉	pwyfc
緹	xjghv
縱	xtwh
終	xtuy
鲍	qgq
骧	cyk
驙	cylg
㰴	ukqw
㲁	pwac
藪	akgt
鬱	srme
丱	njhg
顽	fqd
栨	suqw
鮠	qoqby
䳿	qdoo
匈	qqb
罋	yxtm
谌	yadn
孏	vaui
鯩	qowan
澬	iuqm
㰦	fcqw
繾	xkhp
贸	qyv
鸗	uego
䳎	vwvon
紌	xdnn
㵙	ifkk
軠	ltfg
䱮	qodd
炍	orcy
鵴	qowo
幻	xnn
驸	cwf
藽	ausq
纝	xlli
鰲	gqto
䡷	lafl
鮿	qobn
㤘	nqvg
騅	cwyg
櫠	sywc
㱌	bbbw
衛	tnhh
驗	cwgwo
騍	cjsy
纅	xxrs
䲴	owvo
㾷	urhm
儕	wyjg
鑵	qaky
鲥	qgjf
儰	waeo
繄	atdi
嫰	vgkw
厥	dubw
鵗	qdmo
磃	drhm
鷘	gkioe
閱	uwkq
檵	sxxnj
縑	xuvo
窦	pwfd
緽	xhmy
铅	qmk
鸷	rvyg
鸀	lqjo
沵	iqiy
紤	xrh
絧	xmgk
襃	yqges
簅	tutg
㙠	atdft
頛	didm
綋	xpdc
镬	qawc
负	qm
攏	rued
垴	fybh
葼	aqbt
鶢	efto
鵡	gaho
㣹	tywn
雘	myac
輯	lkbg
驚	aqkc
糙	otf
蓾	ahlo
繣	xvfg
鰾	qosi
箆	tmwx
䠹	tmdw
㽯	lmwk
謰	ylpy
鷚	nweo
駺	cyve
䲩	nwvoq
庚	yvw
㡭	xxgn
告	tfkfz
概	svc
鱒	qouf
鬯	qob
䋧	xndg
䞀	mwnd
嘶	kad
鸅	lfuo
綇	xsgg
卖	fnud
餙	wpqh
批	rx
鷈	wvgmq
儳	wqky
蒮	apwy
頱	efdm
饋	wpkm
㔲	awyv
鴊	ghwo
䩻	afcy
噰	kyxyr
絤	xsg
鞶	temfg
誰	ywyg
䤝	qqbh
紂	xfym
綈	xuxtn
鮶	qovk
穀	fpgcz
局	nnk
飔	mqln
䬬	wyvd
囖	ktly
䃖	dwno
軔	lvyy
䮱	cepy
逸	qkqp
琋	gqdh
揭	rjq
螩	jwhs
蟰	jvfj
䫓	ukdm
㥼	ngho
檚	sssh
銑	qtfqw
縐	xqbtx
䶄	vnuh
賞	ipkmp
隼	wyfjt
縺	xlpy
䫚	mnmm
即	vcb
鲻	qgvll
恡	nqdc
鱐	qovh
縝	xfhwr
颎	xodm
驤	cyke
駳	cthp
䮷	clqj
䮔	ctgf
絙	xgjg
痮	udei
䫈	mwyml
㥠	nnhe
㾅	utnt
畈	lrc
䜲	wwknr
醬	nhdg
咮	kriy
讯	ynf
䜯	wwkou
嶒	muljz
䤔	ilrg
䡢	lyna
飌	akkj
燗	oueg
膥	gsdw
獲	qtac
闃	uhdi
東	gjii
繲	xqeh
魣	qocb
䙪	sqqez
礙	dxth
甏	fkun
㿛	ugmx
艡	teil
肴	qde
櫵	sawo
軟	lqwy
䳌	cewo
蕉	awy
䋓	xqvg
脤	edfe
䱽	qowkh
咨	uqwk
癐	uwgj
承	bd
薢	aqeh
嬜	ujqv
嵔	mlge
軓	lmyy
嶣	mwyos
螮	jaqh
矅	hnwyp
鸵	qynx
饖	wpht
鬢	depm
䊻	xqwyz
蕹	ayxy
撛	roqh
欍	sawv
篨	tbwt
股	emc
驀	ajdca
蟩	jduw
礜	vgnd
輿	vlgw
鎢	qwno
销	qie
輐	lpfq
顲	ooym
䲹	gigo
謕	yrhm
黳	atdos
藙	auec
鱨	qoij
屿	mgn
轄	lpdki
庩	ywti
䕱	agkml
㘓	kugi
樆	sybc
㛴	vvtq
嬱	ilrv
㡜	mhwi
蹚	khif
予	cbj
㔨	quxe
䬶	wyveq
驛	clff
鼟	fkuuq
迩	qip
眽	hrey
鯨	qoyi
爩	osre
絍	xwtf
鶷	pdho
漺	idqq
皠	rmwy
豃	wwktn
䱵	qown
阙	uub
顤	fffm
樺	sagf
駄	cdyy
臦	nhah
紉	xvyyd
悄	ni
㒛	wnwy
嚮	xtyk
脸	ew
䚙	qegg
㦓	nqdo
丧	fue
䒢	aqbjw
廞	yqqw
譭	yvac
顼	gdm
悞	nknd
鯈	whto
厩	dvc
歋	rhaw
搌	rnae
䣤	hhwb
鳡	qgdn
鹩	dujg
緇	xvlg
顈	xxim
䉬	tywc
䳩	svwo
韣	nhkj
滙	iawy
鶈	gvho
韔	nhke
䴀	ujfo